wav\isolated_digits_ti_test_endpt\MAN\AH\1A_endpt.wav	mfctest\1_0.mfc
wav\isolated_digits_ti_test_endpt\MAN\AH\1B_endpt.wav	mfctest\1_1.mfc
wav\isolated_digits_ti_test_endpt\MAN\AH\2A_endpt.wav	mfctest\2_0.mfc
wav\isolated_digits_ti_test_endpt\MAN\AH\2B_endpt.wav	mfctest\2_1.mfc
wav\isolated_digits_ti_test_endpt\MAN\AH\3A_endpt.wav	mfctest\3_0.mfc
wav\isolated_digits_ti_test_endpt\MAN\AH\3B_endpt.wav	mfctest\3_1.mfc
wav\isolated_digits_ti_test_endpt\MAN\AH\4A_endpt.wav	mfctest\4_0.mfc
wav\isolated_digits_ti_test_endpt\MAN\AH\4B_endpt.wav	mfctest\4_1.mfc
wav\isolated_digits_ti_test_endpt\MAN\AH\5A_endpt.wav	mfctest\5_0.mfc
wav\isolated_digits_ti_test_endpt\MAN\AH\5B_endpt.wav	mfctest\5_1.mfc
wav\isolated_digits_ti_test_endpt\MAN\AH\6A_endpt.wav	mfctest\6_0.mfc
wav\isolated_digits_ti_test_endpt\MAN\AH\6B_endpt.wav	mfctest\6_1.mfc
wav\isolated_digits_ti_test_endpt\MAN\AH\7A_endpt.wav	mfctest\7_0.mfc
wav\isolated_digits_ti_test_endpt\MAN\AH\7B_endpt.wav	mfctest\7_1.mfc
wav\isolated_digits_ti_test_endpt\MAN\AH\8A_endpt.wav	mfctest\8_0.mfc
wav\isolated_digits_ti_test_endpt\MAN\AH\8B_endpt.wav	mfctest\8_1.mfc
wav\isolated_digits_ti_test_endpt\MAN\AH\9A_endpt.wav	mfctest\9_0.mfc
wav\isolated_digits_ti_test_endpt\MAN\AH\9B_endpt.wav	mfctest\9_1.mfc
wav\isolated_digits_ti_test_endpt\MAN\AH\OA_endpt.wav	mfctest\10_0.mfc
wav\isolated_digits_ti_test_endpt\MAN\AH\OB_endpt.wav	mfctest\10_1.mfc
wav\isolated_digits_ti_test_endpt\MAN\AH\ZA_endpt.wav	mfctest\0_0.mfc
wav\isolated_digits_ti_test_endpt\MAN\AH\ZB_endpt.wav	mfctest\0_1.mfc
wav\isolated_digits_ti_test_endpt\MAN\AR\1A_endpt.wav	mfctest\1_2.mfc
wav\isolated_digits_ti_test_endpt\MAN\AR\1B_endpt.wav	mfctest\1_3.mfc
wav\isolated_digits_ti_test_endpt\MAN\AR\2A_endpt.wav	mfctest\2_2.mfc
wav\isolated_digits_ti_test_endpt\MAN\AR\2B_endpt.wav	mfctest\2_3.mfc
wav\isolated_digits_ti_test_endpt\MAN\AR\3A_endpt.wav	mfctest\3_2.mfc
wav\isolated_digits_ti_test_endpt\MAN\AR\3B_endpt.wav	mfctest\3_3.mfc
wav\isolated_digits_ti_test_endpt\MAN\AR\4A_endpt.wav	mfctest\4_2.mfc
wav\isolated_digits_ti_test_endpt\MAN\AR\4B_endpt.wav	mfctest\4_3.mfc
wav\isolated_digits_ti_test_endpt\MAN\AR\5A_endpt.wav	mfctest\5_2.mfc
wav\isolated_digits_ti_test_endpt\MAN\AR\5B_endpt.wav	mfctest\5_3.mfc
wav\isolated_digits_ti_test_endpt\MAN\AR\6A_endpt.wav	mfctest\6_2.mfc
wav\isolated_digits_ti_test_endpt\MAN\AR\6B_endpt.wav	mfctest\6_3.mfc
wav\isolated_digits_ti_test_endpt\MAN\AR\7A_endpt.wav	mfctest\7_2.mfc
wav\isolated_digits_ti_test_endpt\MAN\AR\7B_endpt.wav	mfctest\7_3.mfc
wav\isolated_digits_ti_test_endpt\MAN\AR\8A_endpt.wav	mfctest\8_2.mfc
wav\isolated_digits_ti_test_endpt\MAN\AR\8B_endpt.wav	mfctest\8_3.mfc
wav\isolated_digits_ti_test_endpt\MAN\AR\9A_endpt.wav	mfctest\9_2.mfc
wav\isolated_digits_ti_test_endpt\MAN\AR\9B_endpt.wav	mfctest\9_3.mfc
wav\isolated_digits_ti_test_endpt\MAN\AR\OA_endpt.wav	mfctest\10_2.mfc
wav\isolated_digits_ti_test_endpt\MAN\AR\OB_endpt.wav	mfctest\10_3.mfc
wav\isolated_digits_ti_test_endpt\MAN\AR\ZA_endpt.wav	mfctest\0_2.mfc
wav\isolated_digits_ti_test_endpt\MAN\AR\ZB_endpt.wav	mfctest\0_3.mfc
wav\isolated_digits_ti_test_endpt\MAN\AT\1A_endpt.wav	mfctest\1_4.mfc
wav\isolated_digits_ti_test_endpt\MAN\AT\1B_endpt.wav	mfctest\1_5.mfc
wav\isolated_digits_ti_test_endpt\MAN\AT\2A_endpt.wav	mfctest\2_4.mfc
wav\isolated_digits_ti_test_endpt\MAN\AT\2B_endpt.wav	mfctest\2_5.mfc
wav\isolated_digits_ti_test_endpt\MAN\AT\3A_endpt.wav	mfctest\3_4.mfc
wav\isolated_digits_ti_test_endpt\MAN\AT\3B_endpt.wav	mfctest\3_5.mfc
wav\isolated_digits_ti_test_endpt\MAN\AT\4A_endpt.wav	mfctest\4_4.mfc
wav\isolated_digits_ti_test_endpt\MAN\AT\4B_endpt.wav	mfctest\4_5.mfc
wav\isolated_digits_ti_test_endpt\MAN\AT\5A_endpt.wav	mfctest\5_4.mfc
wav\isolated_digits_ti_test_endpt\MAN\AT\5B_endpt.wav	mfctest\5_5.mfc
wav\isolated_digits_ti_test_endpt\MAN\AT\6A_endpt.wav	mfctest\6_4.mfc
wav\isolated_digits_ti_test_endpt\MAN\AT\6B_endpt.wav	mfctest\6_5.mfc
wav\isolated_digits_ti_test_endpt\MAN\AT\7A_endpt.wav	mfctest\7_4.mfc
wav\isolated_digits_ti_test_endpt\MAN\AT\7B_endpt.wav	mfctest\7_5.mfc
wav\isolated_digits_ti_test_endpt\MAN\AT\8A_endpt.wav	mfctest\8_4.mfc
wav\isolated_digits_ti_test_endpt\MAN\AT\8B_endpt.wav	mfctest\8_5.mfc
wav\isolated_digits_ti_test_endpt\MAN\AT\9A_endpt.wav	mfctest\9_4.mfc
wav\isolated_digits_ti_test_endpt\MAN\AT\9B_endpt.wav	mfctest\9_5.mfc
wav\isolated_digits_ti_test_endpt\MAN\AT\OA_endpt.wav	mfctest\10_4.mfc
wav\isolated_digits_ti_test_endpt\MAN\AT\OB_endpt.wav	mfctest\10_5.mfc
wav\isolated_digits_ti_test_endpt\MAN\AT\ZA_endpt.wav	mfctest\0_4.mfc
wav\isolated_digits_ti_test_endpt\MAN\AT\ZB_endpt.wav	mfctest\0_5.mfc
wav\isolated_digits_ti_test_endpt\MAN\BC\1A_endpt.wav	mfctest\1_6.mfc
wav\isolated_digits_ti_test_endpt\MAN\BC\1B_endpt.wav	mfctest\1_7.mfc
wav\isolated_digits_ti_test_endpt\MAN\BC\2A_endpt.wav	mfctest\2_6.mfc
wav\isolated_digits_ti_test_endpt\MAN\BC\2B_endpt.wav	mfctest\2_7.mfc
wav\isolated_digits_ti_test_endpt\MAN\BC\3A_endpt.wav	mfctest\3_6.mfc
wav\isolated_digits_ti_test_endpt\MAN\BC\3B_endpt.wav	mfctest\3_7.mfc
wav\isolated_digits_ti_test_endpt\MAN\BC\4A_endpt.wav	mfctest\4_6.mfc
wav\isolated_digits_ti_test_endpt\MAN\BC\4B_endpt.wav	mfctest\4_7.mfc
wav\isolated_digits_ti_test_endpt\MAN\BC\5A_endpt.wav	mfctest\5_6.mfc
wav\isolated_digits_ti_test_endpt\MAN\BC\5B_endpt.wav	mfctest\5_7.mfc
wav\isolated_digits_ti_test_endpt\MAN\BC\6A_endpt.wav	mfctest\6_6.mfc
wav\isolated_digits_ti_test_endpt\MAN\BC\6B_endpt.wav	mfctest\6_7.mfc
wav\isolated_digits_ti_test_endpt\MAN\BC\7A_endpt.wav	mfctest\7_6.mfc
wav\isolated_digits_ti_test_endpt\MAN\BC\7B_endpt.wav	mfctest\7_7.mfc
wav\isolated_digits_ti_test_endpt\MAN\BC\8A_endpt.wav	mfctest\8_6.mfc
wav\isolated_digits_ti_test_endpt\MAN\BC\8B_endpt.wav	mfctest\8_7.mfc
wav\isolated_digits_ti_test_endpt\MAN\BC\9A_endpt.wav	mfctest\9_6.mfc
wav\isolated_digits_ti_test_endpt\MAN\BC\9B_endpt.wav	mfctest\9_7.mfc
wav\isolated_digits_ti_test_endpt\MAN\BC\OA_endpt.wav	mfctest\10_6.mfc
wav\isolated_digits_ti_test_endpt\MAN\BC\OB_endpt.wav	mfctest\10_7.mfc
wav\isolated_digits_ti_test_endpt\MAN\BC\ZA_endpt.wav	mfctest\0_6.mfc
wav\isolated_digits_ti_test_endpt\MAN\BC\ZB_endpt.wav	mfctest\0_7.mfc
wav\isolated_digits_ti_test_endpt\MAN\BE\1A_endpt.wav	mfctest\1_8.mfc
wav\isolated_digits_ti_test_endpt\MAN\BE\1B_endpt.wav	mfctest\1_9.mfc
wav\isolated_digits_ti_test_endpt\MAN\BE\2A_endpt.wav	mfctest\2_8.mfc
wav\isolated_digits_ti_test_endpt\MAN\BE\2B_endpt.wav	mfctest\2_9.mfc
wav\isolated_digits_ti_test_endpt\MAN\BE\3A_endpt.wav	mfctest\3_8.mfc
wav\isolated_digits_ti_test_endpt\MAN\BE\3B_endpt.wav	mfctest\3_9.mfc
wav\isolated_digits_ti_test_endpt\MAN\BE\4A_endpt.wav	mfctest\4_8.mfc
wav\isolated_digits_ti_test_endpt\MAN\BE\4B_endpt.wav	mfctest\4_9.mfc
wav\isolated_digits_ti_test_endpt\MAN\BE\5A_endpt.wav	mfctest\5_8.mfc
wav\isolated_digits_ti_test_endpt\MAN\BE\5B_endpt.wav	mfctest\5_9.mfc
wav\isolated_digits_ti_test_endpt\MAN\BE\6A_endpt.wav	mfctest\6_8.mfc
wav\isolated_digits_ti_test_endpt\MAN\BE\6B_endpt.wav	mfctest\6_9.mfc
wav\isolated_digits_ti_test_endpt\MAN\BE\7A_endpt.wav	mfctest\7_8.mfc
wav\isolated_digits_ti_test_endpt\MAN\BE\7B_endpt.wav	mfctest\7_9.mfc
wav\isolated_digits_ti_test_endpt\MAN\BE\8A_endpt.wav	mfctest\8_8.mfc
wav\isolated_digits_ti_test_endpt\MAN\BE\8B_endpt.wav	mfctest\8_9.mfc
wav\isolated_digits_ti_test_endpt\MAN\BE\9A_endpt.wav	mfctest\9_8.mfc
wav\isolated_digits_ti_test_endpt\MAN\BE\9B_endpt.wav	mfctest\9_9.mfc
wav\isolated_digits_ti_test_endpt\MAN\BE\OA_endpt.wav	mfctest\10_8.mfc
wav\isolated_digits_ti_test_endpt\MAN\BE\OB_endpt.wav	mfctest\10_9.mfc
wav\isolated_digits_ti_test_endpt\MAN\BE\ZA_endpt.wav	mfctest\0_8.mfc
wav\isolated_digits_ti_test_endpt\MAN\BE\ZB_endpt.wav	mfctest\0_9.mfc
wav\isolated_digits_ti_test_endpt\MAN\BM\1A_endpt.wav	mfctest\1_10.mfc
wav\isolated_digits_ti_test_endpt\MAN\BM\1B_endpt.wav	mfctest\1_11.mfc
wav\isolated_digits_ti_test_endpt\MAN\BM\2A_endpt.wav	mfctest\2_10.mfc
wav\isolated_digits_ti_test_endpt\MAN\BM\2B_endpt.wav	mfctest\2_11.mfc
wav\isolated_digits_ti_test_endpt\MAN\BM\3A_endpt.wav	mfctest\3_10.mfc
wav\isolated_digits_ti_test_endpt\MAN\BM\3B_endpt.wav	mfctest\3_11.mfc
wav\isolated_digits_ti_test_endpt\MAN\BM\4A_endpt.wav	mfctest\4_10.mfc
wav\isolated_digits_ti_test_endpt\MAN\BM\4B_endpt.wav	mfctest\4_11.mfc
wav\isolated_digits_ti_test_endpt\MAN\BM\5A_endpt.wav	mfctest\5_10.mfc
wav\isolated_digits_ti_test_endpt\MAN\BM\5B_endpt.wav	mfctest\5_11.mfc
wav\isolated_digits_ti_test_endpt\MAN\BM\6A_endpt.wav	mfctest\6_10.mfc
wav\isolated_digits_ti_test_endpt\MAN\BM\6B_endpt.wav	mfctest\6_11.mfc
wav\isolated_digits_ti_test_endpt\MAN\BM\7A_endpt.wav	mfctest\7_10.mfc
wav\isolated_digits_ti_test_endpt\MAN\BM\7B_endpt.wav	mfctest\7_11.mfc
wav\isolated_digits_ti_test_endpt\MAN\BM\8A_endpt.wav	mfctest\8_10.mfc
wav\isolated_digits_ti_test_endpt\MAN\BM\8B_endpt.wav	mfctest\8_11.mfc
wav\isolated_digits_ti_test_endpt\MAN\BM\9A_endpt.wav	mfctest\9_10.mfc
wav\isolated_digits_ti_test_endpt\MAN\BM\9B_endpt.wav	mfctest\9_11.mfc
wav\isolated_digits_ti_test_endpt\MAN\BM\OA_endpt.wav	mfctest\10_10.mfc
wav\isolated_digits_ti_test_endpt\MAN\BM\OB_endpt.wav	mfctest\10_11.mfc
wav\isolated_digits_ti_test_endpt\MAN\BM\ZA_endpt.wav	mfctest\0_10.mfc
wav\isolated_digits_ti_test_endpt\MAN\BM\ZB_endpt.wav	mfctest\0_11.mfc
wav\isolated_digits_ti_test_endpt\MAN\BN\1A_endpt.wav	mfctest\1_12.mfc
wav\isolated_digits_ti_test_endpt\MAN\BN\1B_endpt.wav	mfctest\1_13.mfc
wav\isolated_digits_ti_test_endpt\MAN\BN\2A_endpt.wav	mfctest\2_12.mfc
wav\isolated_digits_ti_test_endpt\MAN\BN\2B_endpt.wav	mfctest\2_13.mfc
wav\isolated_digits_ti_test_endpt\MAN\BN\3A_endpt.wav	mfctest\3_12.mfc
wav\isolated_digits_ti_test_endpt\MAN\BN\3B_endpt.wav	mfctest\3_13.mfc
wav\isolated_digits_ti_test_endpt\MAN\BN\4A_endpt.wav	mfctest\4_12.mfc
wav\isolated_digits_ti_test_endpt\MAN\BN\4B_endpt.wav	mfctest\4_13.mfc
wav\isolated_digits_ti_test_endpt\MAN\BN\5A_endpt.wav	mfctest\5_12.mfc
wav\isolated_digits_ti_test_endpt\MAN\BN\5B_endpt.wav	mfctest\5_13.mfc
wav\isolated_digits_ti_test_endpt\MAN\BN\6A_endpt.wav	mfctest\6_12.mfc
wav\isolated_digits_ti_test_endpt\MAN\BN\6B_endpt.wav	mfctest\6_13.mfc
wav\isolated_digits_ti_test_endpt\MAN\BN\7A_endpt.wav	mfctest\7_12.mfc
wav\isolated_digits_ti_test_endpt\MAN\BN\7B_endpt.wav	mfctest\7_13.mfc
wav\isolated_digits_ti_test_endpt\MAN\BN\8A_endpt.wav	mfctest\8_12.mfc
wav\isolated_digits_ti_test_endpt\MAN\BN\8B_endpt.wav	mfctest\8_13.mfc
wav\isolated_digits_ti_test_endpt\MAN\BN\9A_endpt.wav	mfctest\9_12.mfc
wav\isolated_digits_ti_test_endpt\MAN\BN\9B_endpt.wav	mfctest\9_13.mfc
wav\isolated_digits_ti_test_endpt\MAN\BN\OA_endpt.wav	mfctest\10_12.mfc
wav\isolated_digits_ti_test_endpt\MAN\BN\OB_endpt.wav	mfctest\10_13.mfc
wav\isolated_digits_ti_test_endpt\MAN\BN\ZA_endpt.wav	mfctest\0_12.mfc
wav\isolated_digits_ti_test_endpt\MAN\BN\ZB_endpt.wav	mfctest\0_13.mfc
wav\isolated_digits_ti_test_endpt\MAN\CC\1A_endpt.wav	mfctest\1_14.mfc
wav\isolated_digits_ti_test_endpt\MAN\CC\1B_endpt.wav	mfctest\1_15.mfc
wav\isolated_digits_ti_test_endpt\MAN\CC\2A_endpt.wav	mfctest\2_14.mfc
wav\isolated_digits_ti_test_endpt\MAN\CC\2B_endpt.wav	mfctest\2_15.mfc
wav\isolated_digits_ti_test_endpt\MAN\CC\3A_endpt.wav	mfctest\3_14.mfc
wav\isolated_digits_ti_test_endpt\MAN\CC\3B_endpt.wav	mfctest\3_15.mfc
wav\isolated_digits_ti_test_endpt\MAN\CC\4A_endpt.wav	mfctest\4_14.mfc
wav\isolated_digits_ti_test_endpt\MAN\CC\4B_endpt.wav	mfctest\4_15.mfc
wav\isolated_digits_ti_test_endpt\MAN\CC\5A_endpt.wav	mfctest\5_14.mfc
wav\isolated_digits_ti_test_endpt\MAN\CC\5B_endpt.wav	mfctest\5_15.mfc
wav\isolated_digits_ti_test_endpt\MAN\CC\6A_endpt.wav	mfctest\6_14.mfc
wav\isolated_digits_ti_test_endpt\MAN\CC\6B_endpt.wav	mfctest\6_15.mfc
wav\isolated_digits_ti_test_endpt\MAN\CC\7A_endpt.wav	mfctest\7_14.mfc
wav\isolated_digits_ti_test_endpt\MAN\CC\7B_endpt.wav	mfctest\7_15.mfc
wav\isolated_digits_ti_test_endpt\MAN\CC\8A_endpt.wav	mfctest\8_14.mfc
wav\isolated_digits_ti_test_endpt\MAN\CC\8B_endpt.wav	mfctest\8_15.mfc
wav\isolated_digits_ti_test_endpt\MAN\CC\9A_endpt.wav	mfctest\9_14.mfc
wav\isolated_digits_ti_test_endpt\MAN\CC\9B_endpt.wav	mfctest\9_15.mfc
wav\isolated_digits_ti_test_endpt\MAN\CC\OA_endpt.wav	mfctest\10_14.mfc
wav\isolated_digits_ti_test_endpt\MAN\CC\OB_endpt.wav	mfctest\10_15.mfc
wav\isolated_digits_ti_test_endpt\MAN\CC\ZA_endpt.wav	mfctest\0_14.mfc
wav\isolated_digits_ti_test_endpt\MAN\CC\ZB_endpt.wav	mfctest\0_15.mfc
wav\isolated_digits_ti_test_endpt\MAN\CE\1A_endpt.wav	mfctest\1_16.mfc
wav\isolated_digits_ti_test_endpt\MAN\CE\1B_endpt.wav	mfctest\1_17.mfc
wav\isolated_digits_ti_test_endpt\MAN\CE\2A_endpt.wav	mfctest\2_16.mfc
wav\isolated_digits_ti_test_endpt\MAN\CE\2B_endpt.wav	mfctest\2_17.mfc
wav\isolated_digits_ti_test_endpt\MAN\CE\3A_endpt.wav	mfctest\3_16.mfc
wav\isolated_digits_ti_test_endpt\MAN\CE\3B_endpt.wav	mfctest\3_17.mfc
wav\isolated_digits_ti_test_endpt\MAN\CE\4A_endpt.wav	mfctest\4_16.mfc
wav\isolated_digits_ti_test_endpt\MAN\CE\4B_endpt.wav	mfctest\4_17.mfc
wav\isolated_digits_ti_test_endpt\MAN\CE\5A_endpt.wav	mfctest\5_16.mfc
wav\isolated_digits_ti_test_endpt\MAN\CE\5B_endpt.wav	mfctest\5_17.mfc
wav\isolated_digits_ti_test_endpt\MAN\CE\6A_endpt.wav	mfctest\6_16.mfc
wav\isolated_digits_ti_test_endpt\MAN\CE\6B_endpt.wav	mfctest\6_17.mfc
wav\isolated_digits_ti_test_endpt\MAN\CE\7A_endpt.wav	mfctest\7_16.mfc
wav\isolated_digits_ti_test_endpt\MAN\CE\7B_endpt.wav	mfctest\7_17.mfc
wav\isolated_digits_ti_test_endpt\MAN\CE\8A_endpt.wav	mfctest\8_16.mfc
wav\isolated_digits_ti_test_endpt\MAN\CE\8B_endpt.wav	mfctest\8_17.mfc
wav\isolated_digits_ti_test_endpt\MAN\CE\9A_endpt.wav	mfctest\9_16.mfc
wav\isolated_digits_ti_test_endpt\MAN\CE\9B_endpt.wav	mfctest\9_17.mfc
wav\isolated_digits_ti_test_endpt\MAN\CE\OA_endpt.wav	mfctest\10_16.mfc
wav\isolated_digits_ti_test_endpt\MAN\CE\OB_endpt.wav	mfctest\10_17.mfc
wav\isolated_digits_ti_test_endpt\MAN\CE\ZA_endpt.wav	mfctest\0_16.mfc
wav\isolated_digits_ti_test_endpt\MAN\CE\ZB_endpt.wav	mfctest\0_17.mfc
wav\isolated_digits_ti_test_endpt\MAN\CP\1A_endpt.wav	mfctest\1_18.mfc
wav\isolated_digits_ti_test_endpt\MAN\CP\1B_endpt.wav	mfctest\1_19.mfc
wav\isolated_digits_ti_test_endpt\MAN\CP\2A_endpt.wav	mfctest\2_18.mfc
wav\isolated_digits_ti_test_endpt\MAN\CP\2B_endpt.wav	mfctest\2_19.mfc
wav\isolated_digits_ti_test_endpt\MAN\CP\3A_endpt.wav	mfctest\3_18.mfc
wav\isolated_digits_ti_test_endpt\MAN\CP\3B_endpt.wav	mfctest\3_19.mfc
wav\isolated_digits_ti_test_endpt\MAN\CP\4A_endpt.wav	mfctest\4_18.mfc
wav\isolated_digits_ti_test_endpt\MAN\CP\4B_endpt.wav	mfctest\4_19.mfc
wav\isolated_digits_ti_test_endpt\MAN\CP\5A_endpt.wav	mfctest\5_18.mfc
wav\isolated_digits_ti_test_endpt\MAN\CP\5B_endpt.wav	mfctest\5_19.mfc
wav\isolated_digits_ti_test_endpt\MAN\CP\6A_endpt.wav	mfctest\6_18.mfc
wav\isolated_digits_ti_test_endpt\MAN\CP\6B_endpt.wav	mfctest\6_19.mfc
wav\isolated_digits_ti_test_endpt\MAN\CP\7A_endpt.wav	mfctest\7_18.mfc
wav\isolated_digits_ti_test_endpt\MAN\CP\7B_endpt.wav	mfctest\7_19.mfc
wav\isolated_digits_ti_test_endpt\MAN\CP\8A_endpt.wav	mfctest\8_18.mfc
wav\isolated_digits_ti_test_endpt\MAN\CP\8B_endpt.wav	mfctest\8_19.mfc
wav\isolated_digits_ti_test_endpt\MAN\CP\9A_endpt.wav	mfctest\9_18.mfc
wav\isolated_digits_ti_test_endpt\MAN\CP\9B_endpt.wav	mfctest\9_19.mfc
wav\isolated_digits_ti_test_endpt\MAN\CP\OA_endpt.wav	mfctest\10_18.mfc
wav\isolated_digits_ti_test_endpt\MAN\CP\OB_endpt.wav	mfctest\10_19.mfc
wav\isolated_digits_ti_test_endpt\MAN\CP\ZA_endpt.wav	mfctest\0_18.mfc
wav\isolated_digits_ti_test_endpt\MAN\CP\ZB_endpt.wav	mfctest\0_19.mfc
wav\isolated_digits_ti_test_endpt\MAN\DF\1A_endpt.wav	mfctest\1_20.mfc
wav\isolated_digits_ti_test_endpt\MAN\DF\1B_endpt.wav	mfctest\1_21.mfc
wav\isolated_digits_ti_test_endpt\MAN\DF\2A_endpt.wav	mfctest\2_20.mfc
wav\isolated_digits_ti_test_endpt\MAN\DF\2B_endpt.wav	mfctest\2_21.mfc
wav\isolated_digits_ti_test_endpt\MAN\DF\3A_endpt.wav	mfctest\3_20.mfc
wav\isolated_digits_ti_test_endpt\MAN\DF\3B_endpt.wav	mfctest\3_21.mfc
wav\isolated_digits_ti_test_endpt\MAN\DF\4A_endpt.wav	mfctest\4_20.mfc
wav\isolated_digits_ti_test_endpt\MAN\DF\4B_endpt.wav	mfctest\4_21.mfc
wav\isolated_digits_ti_test_endpt\MAN\DF\5A_endpt.wav	mfctest\5_20.mfc
wav\isolated_digits_ti_test_endpt\MAN\DF\5B_endpt.wav	mfctest\5_21.mfc
wav\isolated_digits_ti_test_endpt\MAN\DF\6A_endpt.wav	mfctest\6_20.mfc
wav\isolated_digits_ti_test_endpt\MAN\DF\6B_endpt.wav	mfctest\6_21.mfc
wav\isolated_digits_ti_test_endpt\MAN\DF\7A_endpt.wav	mfctest\7_20.mfc
wav\isolated_digits_ti_test_endpt\MAN\DF\7B_endpt.wav	mfctest\7_21.mfc
wav\isolated_digits_ti_test_endpt\MAN\DF\8A_endpt.wav	mfctest\8_20.mfc
wav\isolated_digits_ti_test_endpt\MAN\DF\8B_endpt.wav	mfctest\8_21.mfc
wav\isolated_digits_ti_test_endpt\MAN\DF\9A_endpt.wav	mfctest\9_20.mfc
wav\isolated_digits_ti_test_endpt\MAN\DF\9B_endpt.wav	mfctest\9_21.mfc
wav\isolated_digits_ti_test_endpt\MAN\DF\OA_endpt.wav	mfctest\10_20.mfc
wav\isolated_digits_ti_test_endpt\MAN\DF\OB_endpt.wav	mfctest\10_21.mfc
wav\isolated_digits_ti_test_endpt\MAN\DF\ZA_endpt.wav	mfctest\0_20.mfc
wav\isolated_digits_ti_test_endpt\MAN\DF\ZB_endpt.wav	mfctest\0_21.mfc
wav\isolated_digits_ti_test_endpt\MAN\DJ\1A_endpt.wav	mfctest\1_22.mfc
wav\isolated_digits_ti_test_endpt\MAN\DJ\1B_endpt.wav	mfctest\1_23.mfc
wav\isolated_digits_ti_test_endpt\MAN\DJ\2A_endpt.wav	mfctest\2_22.mfc
wav\isolated_digits_ti_test_endpt\MAN\DJ\2B_endpt.wav	mfctest\2_23.mfc
wav\isolated_digits_ti_test_endpt\MAN\DJ\3A_endpt.wav	mfctest\3_22.mfc
wav\isolated_digits_ti_test_endpt\MAN\DJ\3B_endpt.wav	mfctest\3_23.mfc
wav\isolated_digits_ti_test_endpt\MAN\DJ\4A_endpt.wav	mfctest\4_22.mfc
wav\isolated_digits_ti_test_endpt\MAN\DJ\4B_endpt.wav	mfctest\4_23.mfc
wav\isolated_digits_ti_test_endpt\MAN\DJ\5A_endpt.wav	mfctest\5_22.mfc
wav\isolated_digits_ti_test_endpt\MAN\DJ\5B_endpt.wav	mfctest\5_23.mfc
wav\isolated_digits_ti_test_endpt\MAN\DJ\6A_endpt.wav	mfctest\6_22.mfc
wav\isolated_digits_ti_test_endpt\MAN\DJ\6B_endpt.wav	mfctest\6_23.mfc
wav\isolated_digits_ti_test_endpt\MAN\DJ\7A_endpt.wav	mfctest\7_22.mfc
wav\isolated_digits_ti_test_endpt\MAN\DJ\7B_endpt.wav	mfctest\7_23.mfc
wav\isolated_digits_ti_test_endpt\MAN\DJ\8A_endpt.wav	mfctest\8_22.mfc
wav\isolated_digits_ti_test_endpt\MAN\DJ\8B_endpt.wav	mfctest\8_23.mfc
wav\isolated_digits_ti_test_endpt\MAN\DJ\9A_endpt.wav	mfctest\9_22.mfc
wav\isolated_digits_ti_test_endpt\MAN\DJ\9B_endpt.wav	mfctest\9_23.mfc
wav\isolated_digits_ti_test_endpt\MAN\DJ\OA_endpt.wav	mfctest\10_22.mfc
wav\isolated_digits_ti_test_endpt\MAN\DJ\OB_endpt.wav	mfctest\10_23.mfc
wav\isolated_digits_ti_test_endpt\MAN\DJ\ZA_endpt.wav	mfctest\0_22.mfc
wav\isolated_digits_ti_test_endpt\MAN\DJ\ZB_endpt.wav	mfctest\0_23.mfc
wav\isolated_digits_ti_test_endpt\MAN\ED\1A_endpt.wav	mfctest\1_24.mfc
wav\isolated_digits_ti_test_endpt\MAN\ED\1B_endpt.wav	mfctest\1_25.mfc
wav\isolated_digits_ti_test_endpt\MAN\ED\2A_endpt.wav	mfctest\2_24.mfc
wav\isolated_digits_ti_test_endpt\MAN\ED\2B_endpt.wav	mfctest\2_25.mfc
wav\isolated_digits_ti_test_endpt\MAN\ED\3A_endpt.wav	mfctest\3_24.mfc
wav\isolated_digits_ti_test_endpt\MAN\ED\3B_endpt.wav	mfctest\3_25.mfc
wav\isolated_digits_ti_test_endpt\MAN\ED\4A_endpt.wav	mfctest\4_24.mfc
wav\isolated_digits_ti_test_endpt\MAN\ED\4B_endpt.wav	mfctest\4_25.mfc
wav\isolated_digits_ti_test_endpt\MAN\ED\5A_endpt.wav	mfctest\5_24.mfc
wav\isolated_digits_ti_test_endpt\MAN\ED\5B_endpt.wav	mfctest\5_25.mfc
wav\isolated_digits_ti_test_endpt\MAN\ED\6A_endpt.wav	mfctest\6_24.mfc
wav\isolated_digits_ti_test_endpt\MAN\ED\6B_endpt.wav	mfctest\6_25.mfc
wav\isolated_digits_ti_test_endpt\MAN\ED\7A_endpt.wav	mfctest\7_24.mfc
wav\isolated_digits_ti_test_endpt\MAN\ED\7B_endpt.wav	mfctest\7_25.mfc
wav\isolated_digits_ti_test_endpt\MAN\ED\8A_endpt.wav	mfctest\8_24.mfc
wav\isolated_digits_ti_test_endpt\MAN\ED\8B_endpt.wav	mfctest\8_25.mfc
wav\isolated_digits_ti_test_endpt\MAN\ED\9A_endpt.wav	mfctest\9_24.mfc
wav\isolated_digits_ti_test_endpt\MAN\ED\9B_endpt.wav	mfctest\9_25.mfc
wav\isolated_digits_ti_test_endpt\MAN\ED\OA_endpt.wav	mfctest\10_24.mfc
wav\isolated_digits_ti_test_endpt\MAN\ED\OB_endpt.wav	mfctest\10_25.mfc
wav\isolated_digits_ti_test_endpt\MAN\ED\ZA_endpt.wav	mfctest\0_24.mfc
wav\isolated_digits_ti_test_endpt\MAN\ED\ZB_endpt.wav	mfctest\0_25.mfc
wav\isolated_digits_ti_test_endpt\MAN\EF\1A_endpt.wav	mfctest\1_26.mfc
wav\isolated_digits_ti_test_endpt\MAN\EF\1B_endpt.wav	mfctest\1_27.mfc
wav\isolated_digits_ti_test_endpt\MAN\EF\2A_endpt.wav	mfctest\2_26.mfc
wav\isolated_digits_ti_test_endpt\MAN\EF\2B_endpt.wav	mfctest\2_27.mfc
wav\isolated_digits_ti_test_endpt\MAN\EF\3A_endpt.wav	mfctest\3_26.mfc
wav\isolated_digits_ti_test_endpt\MAN\EF\3B_endpt.wav	mfctest\3_27.mfc
wav\isolated_digits_ti_test_endpt\MAN\EF\4A_endpt.wav	mfctest\4_26.mfc
wav\isolated_digits_ti_test_endpt\MAN\EF\4B_endpt.wav	mfctest\4_27.mfc
wav\isolated_digits_ti_test_endpt\MAN\EF\5A_endpt.wav	mfctest\5_26.mfc
wav\isolated_digits_ti_test_endpt\MAN\EF\5B_endpt.wav	mfctest\5_27.mfc
wav\isolated_digits_ti_test_endpt\MAN\EF\6A_endpt.wav	mfctest\6_26.mfc
wav\isolated_digits_ti_test_endpt\MAN\EF\6B_endpt.wav	mfctest\6_27.mfc
wav\isolated_digits_ti_test_endpt\MAN\EF\7A_endpt.wav	mfctest\7_26.mfc
wav\isolated_digits_ti_test_endpt\MAN\EF\7B_endpt.wav	mfctest\7_27.mfc
wav\isolated_digits_ti_test_endpt\MAN\EF\8A_endpt.wav	mfctest\8_26.mfc
wav\isolated_digits_ti_test_endpt\MAN\EF\8B_endpt.wav	mfctest\8_27.mfc
wav\isolated_digits_ti_test_endpt\MAN\EF\9A_endpt.wav	mfctest\9_26.mfc
wav\isolated_digits_ti_test_endpt\MAN\EF\9B_endpt.wav	mfctest\9_27.mfc
wav\isolated_digits_ti_test_endpt\MAN\EF\OA_endpt.wav	mfctest\10_26.mfc
wav\isolated_digits_ti_test_endpt\MAN\EF\OB_endpt.wav	mfctest\10_27.mfc
wav\isolated_digits_ti_test_endpt\MAN\EF\ZA_endpt.wav	mfctest\0_26.mfc
wav\isolated_digits_ti_test_endpt\MAN\EF\ZB_endpt.wav	mfctest\0_27.mfc
wav\isolated_digits_ti_test_endpt\MAN\ET\1A_endpt.wav	mfctest\1_28.mfc
wav\isolated_digits_ti_test_endpt\MAN\ET\1B_endpt.wav	mfctest\1_29.mfc
wav\isolated_digits_ti_test_endpt\MAN\ET\2A_endpt.wav	mfctest\2_28.mfc
wav\isolated_digits_ti_test_endpt\MAN\ET\2B_endpt.wav	mfctest\2_29.mfc
wav\isolated_digits_ti_test_endpt\MAN\ET\3A_endpt.wav	mfctest\3_28.mfc
wav\isolated_digits_ti_test_endpt\MAN\ET\3B_endpt.wav	mfctest\3_29.mfc
wav\isolated_digits_ti_test_endpt\MAN\ET\4A_endpt.wav	mfctest\4_28.mfc
wav\isolated_digits_ti_test_endpt\MAN\ET\4B_endpt.wav	mfctest\4_29.mfc
wav\isolated_digits_ti_test_endpt\MAN\ET\5A_endpt.wav	mfctest\5_28.mfc
wav\isolated_digits_ti_test_endpt\MAN\ET\5B_endpt.wav	mfctest\5_29.mfc
wav\isolated_digits_ti_test_endpt\MAN\ET\6A_endpt.wav	mfctest\6_28.mfc
wav\isolated_digits_ti_test_endpt\MAN\ET\6B_endpt.wav	mfctest\6_29.mfc
wav\isolated_digits_ti_test_endpt\MAN\ET\7A_endpt.wav	mfctest\7_28.mfc
wav\isolated_digits_ti_test_endpt\MAN\ET\7B_endpt.wav	mfctest\7_29.mfc
wav\isolated_digits_ti_test_endpt\MAN\ET\8A_endpt.wav	mfctest\8_28.mfc
wav\isolated_digits_ti_test_endpt\MAN\ET\8B_endpt.wav	mfctest\8_29.mfc
wav\isolated_digits_ti_test_endpt\MAN\ET\9A_endpt.wav	mfctest\9_28.mfc
wav\isolated_digits_ti_test_endpt\MAN\ET\9B_endpt.wav	mfctest\9_29.mfc
wav\isolated_digits_ti_test_endpt\MAN\ET\OA_endpt.wav	mfctest\10_28.mfc
wav\isolated_digits_ti_test_endpt\MAN\ET\OB_endpt.wav	mfctest\10_29.mfc
wav\isolated_digits_ti_test_endpt\MAN\ET\ZA_endpt.wav	mfctest\0_28.mfc
wav\isolated_digits_ti_test_endpt\MAN\ET\ZB_endpt.wav	mfctest\0_29.mfc
wav\isolated_digits_ti_test_endpt\MAN\FA\1A_endpt.wav	mfctest\1_30.mfc
wav\isolated_digits_ti_test_endpt\MAN\FA\1B_endpt.wav	mfctest\1_31.mfc
wav\isolated_digits_ti_test_endpt\MAN\FA\2A_endpt.wav	mfctest\2_30.mfc
wav\isolated_digits_ti_test_endpt\MAN\FA\2B_endpt.wav	mfctest\2_31.mfc
wav\isolated_digits_ti_test_endpt\MAN\FA\3A_endpt.wav	mfctest\3_30.mfc
wav\isolated_digits_ti_test_endpt\MAN\FA\3B_endpt.wav	mfctest\3_31.mfc
wav\isolated_digits_ti_test_endpt\MAN\FA\4A_endpt.wav	mfctest\4_30.mfc
wav\isolated_digits_ti_test_endpt\MAN\FA\4B_endpt.wav	mfctest\4_31.mfc
wav\isolated_digits_ti_test_endpt\MAN\FA\5A_endpt.wav	mfctest\5_30.mfc
wav\isolated_digits_ti_test_endpt\MAN\FA\5B_endpt.wav	mfctest\5_31.mfc
wav\isolated_digits_ti_test_endpt\MAN\FA\6A_endpt.wav	mfctest\6_30.mfc
wav\isolated_digits_ti_test_endpt\MAN\FA\6B_endpt.wav	mfctest\6_31.mfc
wav\isolated_digits_ti_test_endpt\MAN\FA\7A_endpt.wav	mfctest\7_30.mfc
wav\isolated_digits_ti_test_endpt\MAN\FA\7B_endpt.wav	mfctest\7_31.mfc
wav\isolated_digits_ti_test_endpt\MAN\FA\8A_endpt.wav	mfctest\8_30.mfc
wav\isolated_digits_ti_test_endpt\MAN\FA\8B_endpt.wav	mfctest\8_31.mfc
wav\isolated_digits_ti_test_endpt\MAN\FA\9A_endpt.wav	mfctest\9_30.mfc
wav\isolated_digits_ti_test_endpt\MAN\FA\9B_endpt.wav	mfctest\9_31.mfc
wav\isolated_digits_ti_test_endpt\MAN\FA\OA_endpt.wav	mfctest\10_30.mfc
wav\isolated_digits_ti_test_endpt\MAN\FA\OB_endpt.wav	mfctest\10_31.mfc
wav\isolated_digits_ti_test_endpt\MAN\FA\ZA_endpt.wav	mfctest\0_30.mfc
wav\isolated_digits_ti_test_endpt\MAN\FA\ZB_endpt.wav	mfctest\0_31.mfc
wav\isolated_digits_ti_test_endpt\MAN\FG\1A_endpt.wav	mfctest\1_32.mfc
wav\isolated_digits_ti_test_endpt\MAN\FG\1B_endpt.wav	mfctest\1_33.mfc
wav\isolated_digits_ti_test_endpt\MAN\FG\2A_endpt.wav	mfctest\2_32.mfc
wav\isolated_digits_ti_test_endpt\MAN\FG\2B_endpt.wav	mfctest\2_33.mfc
wav\isolated_digits_ti_test_endpt\MAN\FG\3A_endpt.wav	mfctest\3_32.mfc
wav\isolated_digits_ti_test_endpt\MAN\FG\3B_endpt.wav	mfctest\3_33.mfc
wav\isolated_digits_ti_test_endpt\MAN\FG\4A_endpt.wav	mfctest\4_32.mfc
wav\isolated_digits_ti_test_endpt\MAN\FG\4B_endpt.wav	mfctest\4_33.mfc
wav\isolated_digits_ti_test_endpt\MAN\FG\5A_endpt.wav	mfctest\5_32.mfc
wav\isolated_digits_ti_test_endpt\MAN\FG\5B_endpt.wav	mfctest\5_33.mfc
wav\isolated_digits_ti_test_endpt\MAN\FG\6A_endpt.wav	mfctest\6_32.mfc
wav\isolated_digits_ti_test_endpt\MAN\FG\6B_endpt.wav	mfctest\6_33.mfc
wav\isolated_digits_ti_test_endpt\MAN\FG\7A_endpt.wav	mfctest\7_32.mfc
wav\isolated_digits_ti_test_endpt\MAN\FG\7B_endpt.wav	mfctest\7_33.mfc
wav\isolated_digits_ti_test_endpt\MAN\FG\8A_endpt.wav	mfctest\8_32.mfc
wav\isolated_digits_ti_test_endpt\MAN\FG\8B_endpt.wav	mfctest\8_33.mfc
wav\isolated_digits_ti_test_endpt\MAN\FG\9A_endpt.wav	mfctest\9_32.mfc
wav\isolated_digits_ti_test_endpt\MAN\FG\9B_endpt.wav	mfctest\9_33.mfc
wav\isolated_digits_ti_test_endpt\MAN\FG\OA_endpt.wav	mfctest\10_32.mfc
wav\isolated_digits_ti_test_endpt\MAN\FG\OB_endpt.wav	mfctest\10_33.mfc
wav\isolated_digits_ti_test_endpt\MAN\FG\ZA_endpt.wav	mfctest\0_32.mfc
wav\isolated_digits_ti_test_endpt\MAN\FG\ZB_endpt.wav	mfctest\0_33.mfc
wav\isolated_digits_ti_test_endpt\MAN\FH\1A_endpt.wav	mfctest\1_34.mfc
wav\isolated_digits_ti_test_endpt\MAN\FH\1B_endpt.wav	mfctest\1_35.mfc
wav\isolated_digits_ti_test_endpt\MAN\FH\2A_endpt.wav	mfctest\2_34.mfc
wav\isolated_digits_ti_test_endpt\MAN\FH\2B_endpt.wav	mfctest\2_35.mfc
wav\isolated_digits_ti_test_endpt\MAN\FH\3A_endpt.wav	mfctest\3_34.mfc
wav\isolated_digits_ti_test_endpt\MAN\FH\3B_endpt.wav	mfctest\3_35.mfc
wav\isolated_digits_ti_test_endpt\MAN\FH\4A_endpt.wav	mfctest\4_34.mfc
wav\isolated_digits_ti_test_endpt\MAN\FH\4B_endpt.wav	mfctest\4_35.mfc
wav\isolated_digits_ti_test_endpt\MAN\FH\5A_endpt.wav	mfctest\5_34.mfc
wav\isolated_digits_ti_test_endpt\MAN\FH\5B_endpt.wav	mfctest\5_35.mfc
wav\isolated_digits_ti_test_endpt\MAN\FH\6A_endpt.wav	mfctest\6_34.mfc
wav\isolated_digits_ti_test_endpt\MAN\FH\6B_endpt.wav	mfctest\6_35.mfc
wav\isolated_digits_ti_test_endpt\MAN\FH\7A_endpt.wav	mfctest\7_34.mfc
wav\isolated_digits_ti_test_endpt\MAN\FH\7B_endpt.wav	mfctest\7_35.mfc
wav\isolated_digits_ti_test_endpt\MAN\FH\8A_endpt.wav	mfctest\8_34.mfc
wav\isolated_digits_ti_test_endpt\MAN\FH\8B_endpt.wav	mfctest\8_35.mfc
wav\isolated_digits_ti_test_endpt\MAN\FH\9A_endpt.wav	mfctest\9_34.mfc
wav\isolated_digits_ti_test_endpt\MAN\FH\9B_endpt.wav	mfctest\9_35.mfc
wav\isolated_digits_ti_test_endpt\MAN\FH\OA_endpt.wav	mfctest\10_34.mfc
wav\isolated_digits_ti_test_endpt\MAN\FH\OB_endpt.wav	mfctest\10_35.mfc
wav\isolated_digits_ti_test_endpt\MAN\FH\ZA_endpt.wav	mfctest\0_34.mfc
wav\isolated_digits_ti_test_endpt\MAN\FH\ZB_endpt.wav	mfctest\0_35.mfc
wav\isolated_digits_ti_test_endpt\MAN\FM\1A_endpt.wav	mfctest\1_36.mfc
wav\isolated_digits_ti_test_endpt\MAN\FM\1B_endpt.wav	mfctest\1_37.mfc
wav\isolated_digits_ti_test_endpt\MAN\FM\2A_endpt.wav	mfctest\2_36.mfc
wav\isolated_digits_ti_test_endpt\MAN\FM\2B_endpt.wav	mfctest\2_37.mfc
wav\isolated_digits_ti_test_endpt\MAN\FM\3A_endpt.wav	mfctest\3_36.mfc
wav\isolated_digits_ti_test_endpt\MAN\FM\3B_endpt.wav	mfctest\3_37.mfc
wav\isolated_digits_ti_test_endpt\MAN\FM\4A_endpt.wav	mfctest\4_36.mfc
wav\isolated_digits_ti_test_endpt\MAN\FM\4B_endpt.wav	mfctest\4_37.mfc
wav\isolated_digits_ti_test_endpt\MAN\FM\5A_endpt.wav	mfctest\5_36.mfc
wav\isolated_digits_ti_test_endpt\MAN\FM\5B_endpt.wav	mfctest\5_37.mfc
wav\isolated_digits_ti_test_endpt\MAN\FM\6A_endpt.wav	mfctest\6_36.mfc
wav\isolated_digits_ti_test_endpt\MAN\FM\6B_endpt.wav	mfctest\6_37.mfc
wav\isolated_digits_ti_test_endpt\MAN\FM\7A_endpt.wav	mfctest\7_36.mfc
wav\isolated_digits_ti_test_endpt\MAN\FM\7B_endpt.wav	mfctest\7_37.mfc
wav\isolated_digits_ti_test_endpt\MAN\FM\8A_endpt.wav	mfctest\8_36.mfc
wav\isolated_digits_ti_test_endpt\MAN\FM\8B_endpt.wav	mfctest\8_37.mfc
wav\isolated_digits_ti_test_endpt\MAN\FM\9A_endpt.wav	mfctest\9_36.mfc
wav\isolated_digits_ti_test_endpt\MAN\FM\9B_endpt.wav	mfctest\9_37.mfc
wav\isolated_digits_ti_test_endpt\MAN\FM\OA_endpt.wav	mfctest\10_36.mfc
wav\isolated_digits_ti_test_endpt\MAN\FM\OB_endpt.wav	mfctest\10_37.mfc
wav\isolated_digits_ti_test_endpt\MAN\FM\ZA_endpt.wav	mfctest\0_36.mfc
wav\isolated_digits_ti_test_endpt\MAN\FM\ZB_endpt.wav	mfctest\0_37.mfc
wav\isolated_digits_ti_test_endpt\MAN\FP\1A_endpt.wav	mfctest\1_38.mfc
wav\isolated_digits_ti_test_endpt\MAN\FP\1B_endpt.wav	mfctest\1_39.mfc
wav\isolated_digits_ti_test_endpt\MAN\FP\2A_endpt.wav	mfctest\2_38.mfc
wav\isolated_digits_ti_test_endpt\MAN\FP\2B_endpt.wav	mfctest\2_39.mfc
wav\isolated_digits_ti_test_endpt\MAN\FP\3A_endpt.wav	mfctest\3_38.mfc
wav\isolated_digits_ti_test_endpt\MAN\FP\3B_endpt.wav	mfctest\3_39.mfc
wav\isolated_digits_ti_test_endpt\MAN\FP\4A_endpt.wav	mfctest\4_38.mfc
wav\isolated_digits_ti_test_endpt\MAN\FP\4B_endpt.wav	mfctest\4_39.mfc
wav\isolated_digits_ti_test_endpt\MAN\FP\5A_endpt.wav	mfctest\5_38.mfc
wav\isolated_digits_ti_test_endpt\MAN\FP\5B_endpt.wav	mfctest\5_39.mfc
wav\isolated_digits_ti_test_endpt\MAN\FP\6A_endpt.wav	mfctest\6_38.mfc
wav\isolated_digits_ti_test_endpt\MAN\FP\6B_endpt.wav	mfctest\6_39.mfc
wav\isolated_digits_ti_test_endpt\MAN\FP\7A_endpt.wav	mfctest\7_38.mfc
wav\isolated_digits_ti_test_endpt\MAN\FP\7B_endpt.wav	mfctest\7_39.mfc
wav\isolated_digits_ti_test_endpt\MAN\FP\8A_endpt.wav	mfctest\8_38.mfc
wav\isolated_digits_ti_test_endpt\MAN\FP\8B_endpt.wav	mfctest\8_39.mfc
wav\isolated_digits_ti_test_endpt\MAN\FP\9A_endpt.wav	mfctest\9_38.mfc
wav\isolated_digits_ti_test_endpt\MAN\FP\9B_endpt.wav	mfctest\9_39.mfc
wav\isolated_digits_ti_test_endpt\MAN\FP\OA_endpt.wav	mfctest\10_38.mfc
wav\isolated_digits_ti_test_endpt\MAN\FP\OB_endpt.wav	mfctest\10_39.mfc
wav\isolated_digits_ti_test_endpt\MAN\FP\ZA_endpt.wav	mfctest\0_38.mfc
wav\isolated_digits_ti_test_endpt\MAN\FP\ZB_endpt.wav	mfctest\0_39.mfc
wav\isolated_digits_ti_test_endpt\MAN\FR\1A_endpt.wav	mfctest\1_40.mfc
wav\isolated_digits_ti_test_endpt\MAN\FR\1B_endpt.wav	mfctest\1_41.mfc
wav\isolated_digits_ti_test_endpt\MAN\FR\2A_endpt.wav	mfctest\2_40.mfc
wav\isolated_digits_ti_test_endpt\MAN\FR\2B_endpt.wav	mfctest\2_41.mfc
wav\isolated_digits_ti_test_endpt\MAN\FR\3A_endpt.wav	mfctest\3_40.mfc
wav\isolated_digits_ti_test_endpt\MAN\FR\3B_endpt.wav	mfctest\3_41.mfc
wav\isolated_digits_ti_test_endpt\MAN\FR\4A_endpt.wav	mfctest\4_40.mfc
wav\isolated_digits_ti_test_endpt\MAN\FR\4B_endpt.wav	mfctest\4_41.mfc
wav\isolated_digits_ti_test_endpt\MAN\FR\5A_endpt.wav	mfctest\5_40.mfc
wav\isolated_digits_ti_test_endpt\MAN\FR\5B_endpt.wav	mfctest\5_41.mfc
wav\isolated_digits_ti_test_endpt\MAN\FR\6A_endpt.wav	mfctest\6_40.mfc
wav\isolated_digits_ti_test_endpt\MAN\FR\6B_endpt.wav	mfctest\6_41.mfc
wav\isolated_digits_ti_test_endpt\MAN\FR\7A_endpt.wav	mfctest\7_40.mfc
wav\isolated_digits_ti_test_endpt\MAN\FR\7B_endpt.wav	mfctest\7_41.mfc
wav\isolated_digits_ti_test_endpt\MAN\FR\8A_endpt.wav	mfctest\8_40.mfc
wav\isolated_digits_ti_test_endpt\MAN\FR\8B_endpt.wav	mfctest\8_41.mfc
wav\isolated_digits_ti_test_endpt\MAN\FR\9A_endpt.wav	mfctest\9_40.mfc
wav\isolated_digits_ti_test_endpt\MAN\FR\9B_endpt.wav	mfctest\9_41.mfc
wav\isolated_digits_ti_test_endpt\MAN\FR\OA_endpt.wav	mfctest\10_40.mfc
wav\isolated_digits_ti_test_endpt\MAN\FR\OB_endpt.wav	mfctest\10_41.mfc
wav\isolated_digits_ti_test_endpt\MAN\FR\ZA_endpt.wav	mfctest\0_40.mfc
wav\isolated_digits_ti_test_endpt\MAN\FR\ZB_endpt.wav	mfctest\0_41.mfc
wav\isolated_digits_ti_test_endpt\MAN\FS\1A_endpt.wav	mfctest\1_42.mfc
wav\isolated_digits_ti_test_endpt\MAN\FS\1B_endpt.wav	mfctest\1_43.mfc
wav\isolated_digits_ti_test_endpt\MAN\FS\2A_endpt.wav	mfctest\2_42.mfc
wav\isolated_digits_ti_test_endpt\MAN\FS\2B_endpt.wav	mfctest\2_43.mfc
wav\isolated_digits_ti_test_endpt\MAN\FS\3A_endpt.wav	mfctest\3_42.mfc
wav\isolated_digits_ti_test_endpt\MAN\FS\3B_endpt.wav	mfctest\3_43.mfc
wav\isolated_digits_ti_test_endpt\MAN\FS\4A_endpt.wav	mfctest\4_42.mfc
wav\isolated_digits_ti_test_endpt\MAN\FS\4B_endpt.wav	mfctest\4_43.mfc
wav\isolated_digits_ti_test_endpt\MAN\FS\5A_endpt.wav	mfctest\5_42.mfc
wav\isolated_digits_ti_test_endpt\MAN\FS\5B_endpt.wav	mfctest\5_43.mfc
wav\isolated_digits_ti_test_endpt\MAN\FS\6A_endpt.wav	mfctest\6_42.mfc
wav\isolated_digits_ti_test_endpt\MAN\FS\6B_endpt.wav	mfctest\6_43.mfc
wav\isolated_digits_ti_test_endpt\MAN\FS\7A_endpt.wav	mfctest\7_42.mfc
wav\isolated_digits_ti_test_endpt\MAN\FS\7B_endpt.wav	mfctest\7_43.mfc
wav\isolated_digits_ti_test_endpt\MAN\FS\8A_endpt.wav	mfctest\8_42.mfc
wav\isolated_digits_ti_test_endpt\MAN\FS\8B_endpt.wav	mfctest\8_43.mfc
wav\isolated_digits_ti_test_endpt\MAN\FS\9A_endpt.wav	mfctest\9_42.mfc
wav\isolated_digits_ti_test_endpt\MAN\FS\9B_endpt.wav	mfctest\9_43.mfc
wav\isolated_digits_ti_test_endpt\MAN\FS\OA_endpt.wav	mfctest\10_42.mfc
wav\isolated_digits_ti_test_endpt\MAN\FS\OB_endpt.wav	mfctest\10_43.mfc
wav\isolated_digits_ti_test_endpt\MAN\FS\ZA_endpt.wav	mfctest\0_42.mfc
wav\isolated_digits_ti_test_endpt\MAN\FS\ZB_endpt.wav	mfctest\0_43.mfc
wav\isolated_digits_ti_test_endpt\MAN\FT\1A_endpt.wav	mfctest\1_44.mfc
wav\isolated_digits_ti_test_endpt\MAN\FT\1B_endpt.wav	mfctest\1_45.mfc
wav\isolated_digits_ti_test_endpt\MAN\FT\2A_endpt.wav	mfctest\2_44.mfc
wav\isolated_digits_ti_test_endpt\MAN\FT\2B_endpt.wav	mfctest\2_45.mfc
wav\isolated_digits_ti_test_endpt\MAN\FT\3A_endpt.wav	mfctest\3_44.mfc
wav\isolated_digits_ti_test_endpt\MAN\FT\3B_endpt.wav	mfctest\3_45.mfc
wav\isolated_digits_ti_test_endpt\MAN\FT\4A_endpt.wav	mfctest\4_44.mfc
wav\isolated_digits_ti_test_endpt\MAN\FT\4B_endpt.wav	mfctest\4_45.mfc
wav\isolated_digits_ti_test_endpt\MAN\FT\5A_endpt.wav	mfctest\5_44.mfc
wav\isolated_digits_ti_test_endpt\MAN\FT\5B_endpt.wav	mfctest\5_45.mfc
wav\isolated_digits_ti_test_endpt\MAN\FT\6A_endpt.wav	mfctest\6_44.mfc
wav\isolated_digits_ti_test_endpt\MAN\FT\6B_endpt.wav	mfctest\6_45.mfc
wav\isolated_digits_ti_test_endpt\MAN\FT\7A_endpt.wav	mfctest\7_44.mfc
wav\isolated_digits_ti_test_endpt\MAN\FT\7B_endpt.wav	mfctest\7_45.mfc
wav\isolated_digits_ti_test_endpt\MAN\FT\8A_endpt.wav	mfctest\8_44.mfc
wav\isolated_digits_ti_test_endpt\MAN\FT\8B_endpt.wav	mfctest\8_45.mfc
wav\isolated_digits_ti_test_endpt\MAN\FT\9A_endpt.wav	mfctest\9_44.mfc
wav\isolated_digits_ti_test_endpt\MAN\FT\9B_endpt.wav	mfctest\9_45.mfc
wav\isolated_digits_ti_test_endpt\MAN\FT\OA_endpt.wav	mfctest\10_44.mfc
wav\isolated_digits_ti_test_endpt\MAN\FT\OB_endpt.wav	mfctest\10_45.mfc
wav\isolated_digits_ti_test_endpt\MAN\FT\ZA_endpt.wav	mfctest\0_44.mfc
wav\isolated_digits_ti_test_endpt\MAN\FT\ZB_endpt.wav	mfctest\0_45.mfc
wav\isolated_digits_ti_test_endpt\MAN\GA\1A_endpt.wav	mfctest\1_46.mfc
wav\isolated_digits_ti_test_endpt\MAN\GA\1B_endpt.wav	mfctest\1_47.mfc
wav\isolated_digits_ti_test_endpt\MAN\GA\2A_endpt.wav	mfctest\2_46.mfc
wav\isolated_digits_ti_test_endpt\MAN\GA\2B_endpt.wav	mfctest\2_47.mfc
wav\isolated_digits_ti_test_endpt\MAN\GA\3A_endpt.wav	mfctest\3_46.mfc
wav\isolated_digits_ti_test_endpt\MAN\GA\3B_endpt.wav	mfctest\3_47.mfc
wav\isolated_digits_ti_test_endpt\MAN\GA\4A_endpt.wav	mfctest\4_46.mfc
wav\isolated_digits_ti_test_endpt\MAN\GA\4B_endpt.wav	mfctest\4_47.mfc
wav\isolated_digits_ti_test_endpt\MAN\GA\5A_endpt.wav	mfctest\5_46.mfc
wav\isolated_digits_ti_test_endpt\MAN\GA\5B_endpt.wav	mfctest\5_47.mfc
wav\isolated_digits_ti_test_endpt\MAN\GA\6A_endpt.wav	mfctest\6_46.mfc
wav\isolated_digits_ti_test_endpt\MAN\GA\6B_endpt.wav	mfctest\6_47.mfc
wav\isolated_digits_ti_test_endpt\MAN\GA\7A_endpt.wav	mfctest\7_46.mfc
wav\isolated_digits_ti_test_endpt\MAN\GA\7B_endpt.wav	mfctest\7_47.mfc
wav\isolated_digits_ti_test_endpt\MAN\GA\8A_endpt.wav	mfctest\8_46.mfc
wav\isolated_digits_ti_test_endpt\MAN\GA\8B_endpt.wav	mfctest\8_47.mfc
wav\isolated_digits_ti_test_endpt\MAN\GA\9A_endpt.wav	mfctest\9_46.mfc
wav\isolated_digits_ti_test_endpt\MAN\GA\9B_endpt.wav	mfctest\9_47.mfc
wav\isolated_digits_ti_test_endpt\MAN\GA\OA_endpt.wav	mfctest\10_46.mfc
wav\isolated_digits_ti_test_endpt\MAN\GA\OB_endpt.wav	mfctest\10_47.mfc
wav\isolated_digits_ti_test_endpt\MAN\GA\ZA_endpt.wav	mfctest\0_46.mfc
wav\isolated_digits_ti_test_endpt\MAN\GA\ZB_endpt.wav	mfctest\0_47.mfc
wav\isolated_digits_ti_test_endpt\MAN\GP\1A_endpt.wav	mfctest\1_48.mfc
wav\isolated_digits_ti_test_endpt\MAN\GP\1B_endpt.wav	mfctest\1_49.mfc
wav\isolated_digits_ti_test_endpt\MAN\GP\2A_endpt.wav	mfctest\2_48.mfc
wav\isolated_digits_ti_test_endpt\MAN\GP\2B_endpt.wav	mfctest\2_49.mfc
wav\isolated_digits_ti_test_endpt\MAN\GP\3A_endpt.wav	mfctest\3_48.mfc
wav\isolated_digits_ti_test_endpt\MAN\GP\3B_endpt.wav	mfctest\3_49.mfc
wav\isolated_digits_ti_test_endpt\MAN\GP\4A_endpt.wav	mfctest\4_48.mfc
wav\isolated_digits_ti_test_endpt\MAN\GP\4B_endpt.wav	mfctest\4_49.mfc
wav\isolated_digits_ti_test_endpt\MAN\GP\5A_endpt.wav	mfctest\5_48.mfc
wav\isolated_digits_ti_test_endpt\MAN\GP\5B_endpt.wav	mfctest\5_49.mfc
wav\isolated_digits_ti_test_endpt\MAN\GP\6A_endpt.wav	mfctest\6_48.mfc
wav\isolated_digits_ti_test_endpt\MAN\GP\6B_endpt.wav	mfctest\6_49.mfc
wav\isolated_digits_ti_test_endpt\MAN\GP\7A_endpt.wav	mfctest\7_48.mfc
wav\isolated_digits_ti_test_endpt\MAN\GP\7B_endpt.wav	mfctest\7_49.mfc
wav\isolated_digits_ti_test_endpt\MAN\GP\8A_endpt.wav	mfctest\8_48.mfc
wav\isolated_digits_ti_test_endpt\MAN\GP\8B_endpt.wav	mfctest\8_49.mfc
wav\isolated_digits_ti_test_endpt\MAN\GP\9A_endpt.wav	mfctest\9_48.mfc
wav\isolated_digits_ti_test_endpt\MAN\GP\9B_endpt.wav	mfctest\9_49.mfc
wav\isolated_digits_ti_test_endpt\MAN\GP\OA_endpt.wav	mfctest\10_48.mfc
wav\isolated_digits_ti_test_endpt\MAN\GP\OB_endpt.wav	mfctest\10_49.mfc
wav\isolated_digits_ti_test_endpt\MAN\GP\ZA_endpt.wav	mfctest\0_48.mfc
wav\isolated_digits_ti_test_endpt\MAN\GP\ZB_endpt.wav	mfctest\0_49.mfc
wav\isolated_digits_ti_test_endpt\MAN\GS\1A_endpt.wav	mfctest\1_50.mfc
wav\isolated_digits_ti_test_endpt\MAN\GS\1B_endpt.wav	mfctest\1_51.mfc
wav\isolated_digits_ti_test_endpt\MAN\GS\2A_endpt.wav	mfctest\2_50.mfc
wav\isolated_digits_ti_test_endpt\MAN\GS\2B_endpt.wav	mfctest\2_51.mfc
wav\isolated_digits_ti_test_endpt\MAN\GS\3A_endpt.wav	mfctest\3_50.mfc
wav\isolated_digits_ti_test_endpt\MAN\GS\3B_endpt.wav	mfctest\3_51.mfc
wav\isolated_digits_ti_test_endpt\MAN\GS\4A_endpt.wav	mfctest\4_50.mfc
wav\isolated_digits_ti_test_endpt\MAN\GS\4B_endpt.wav	mfctest\4_51.mfc
wav\isolated_digits_ti_test_endpt\MAN\GS\5A_endpt.wav	mfctest\5_50.mfc
wav\isolated_digits_ti_test_endpt\MAN\GS\5B_endpt.wav	mfctest\5_51.mfc
wav\isolated_digits_ti_test_endpt\MAN\GS\6A_endpt.wav	mfctest\6_50.mfc
wav\isolated_digits_ti_test_endpt\MAN\GS\6B_endpt.wav	mfctest\6_51.mfc
wav\isolated_digits_ti_test_endpt\MAN\GS\7A_endpt.wav	mfctest\7_50.mfc
wav\isolated_digits_ti_test_endpt\MAN\GS\7B_endpt.wav	mfctest\7_51.mfc
wav\isolated_digits_ti_test_endpt\MAN\GS\8A_endpt.wav	mfctest\8_50.mfc
wav\isolated_digits_ti_test_endpt\MAN\GS\8B_endpt.wav	mfctest\8_51.mfc
wav\isolated_digits_ti_test_endpt\MAN\GS\9A_endpt.wav	mfctest\9_50.mfc
wav\isolated_digits_ti_test_endpt\MAN\GS\9B_endpt.wav	mfctest\9_51.mfc
wav\isolated_digits_ti_test_endpt\MAN\GS\OA_endpt.wav	mfctest\10_50.mfc
wav\isolated_digits_ti_test_endpt\MAN\GS\OB_endpt.wav	mfctest\10_51.mfc
wav\isolated_digits_ti_test_endpt\MAN\GS\ZA_endpt.wav	mfctest\0_50.mfc
wav\isolated_digits_ti_test_endpt\MAN\GS\ZB_endpt.wav	mfctest\0_51.mfc
wav\isolated_digits_ti_test_endpt\MAN\GW\1A_endpt.wav	mfctest\1_52.mfc
wav\isolated_digits_ti_test_endpt\MAN\GW\1B_endpt.wav	mfctest\1_53.mfc
wav\isolated_digits_ti_test_endpt\MAN\GW\2A_endpt.wav	mfctest\2_52.mfc
wav\isolated_digits_ti_test_endpt\MAN\GW\2B_endpt.wav	mfctest\2_53.mfc
wav\isolated_digits_ti_test_endpt\MAN\GW\3A_endpt.wav	mfctest\3_52.mfc
wav\isolated_digits_ti_test_endpt\MAN\GW\3B_endpt.wav	mfctest\3_53.mfc
wav\isolated_digits_ti_test_endpt\MAN\GW\4A_endpt.wav	mfctest\4_52.mfc
wav\isolated_digits_ti_test_endpt\MAN\GW\4B_endpt.wav	mfctest\4_53.mfc
wav\isolated_digits_ti_test_endpt\MAN\GW\5A_endpt.wav	mfctest\5_52.mfc
wav\isolated_digits_ti_test_endpt\MAN\GW\5B_endpt.wav	mfctest\5_53.mfc
wav\isolated_digits_ti_test_endpt\MAN\GW\6A_endpt.wav	mfctest\6_52.mfc
wav\isolated_digits_ti_test_endpt\MAN\GW\6B_endpt.wav	mfctest\6_53.mfc
wav\isolated_digits_ti_test_endpt\MAN\GW\7A_endpt.wav	mfctest\7_52.mfc
wav\isolated_digits_ti_test_endpt\MAN\GW\7B_endpt.wav	mfctest\7_53.mfc
wav\isolated_digits_ti_test_endpt\MAN\GW\8A_endpt.wav	mfctest\8_52.mfc
wav\isolated_digits_ti_test_endpt\MAN\GW\8B_endpt.wav	mfctest\8_53.mfc
wav\isolated_digits_ti_test_endpt\MAN\GW\9A_endpt.wav	mfctest\9_52.mfc
wav\isolated_digits_ti_test_endpt\MAN\GW\9B_endpt.wav	mfctest\9_53.mfc
wav\isolated_digits_ti_test_endpt\MAN\GW\OA_endpt.wav	mfctest\10_52.mfc
wav\isolated_digits_ti_test_endpt\MAN\GW\OB_endpt.wav	mfctest\10_53.mfc
wav\isolated_digits_ti_test_endpt\MAN\GW\ZA_endpt.wav	mfctest\0_52.mfc
wav\isolated_digits_ti_test_endpt\MAN\GW\ZB_endpt.wav	mfctest\0_53.mfc
wav\isolated_digits_ti_test_endpt\MAN\HC\1A_endpt.wav	mfctest\1_54.mfc
wav\isolated_digits_ti_test_endpt\MAN\HC\1B_endpt.wav	mfctest\1_55.mfc
wav\isolated_digits_ti_test_endpt\MAN\HC\2A_endpt.wav	mfctest\2_54.mfc
wav\isolated_digits_ti_test_endpt\MAN\HC\2B_endpt.wav	mfctest\2_55.mfc
wav\isolated_digits_ti_test_endpt\MAN\HC\3A_endpt.wav	mfctest\3_54.mfc
wav\isolated_digits_ti_test_endpt\MAN\HC\3B_endpt.wav	mfctest\3_55.mfc
wav\isolated_digits_ti_test_endpt\MAN\HC\4A_endpt.wav	mfctest\4_54.mfc
wav\isolated_digits_ti_test_endpt\MAN\HC\4B_endpt.wav	mfctest\4_55.mfc
wav\isolated_digits_ti_test_endpt\MAN\HC\5A_endpt.wav	mfctest\5_54.mfc
wav\isolated_digits_ti_test_endpt\MAN\HC\5B_endpt.wav	mfctest\5_55.mfc
wav\isolated_digits_ti_test_endpt\MAN\HC\6A_endpt.wav	mfctest\6_54.mfc
wav\isolated_digits_ti_test_endpt\MAN\HC\6B_endpt.wav	mfctest\6_55.mfc
wav\isolated_digits_ti_test_endpt\MAN\HC\7A_endpt.wav	mfctest\7_54.mfc
wav\isolated_digits_ti_test_endpt\MAN\HC\7B_endpt.wav	mfctest\7_55.mfc
wav\isolated_digits_ti_test_endpt\MAN\HC\8A_endpt.wav	mfctest\8_54.mfc
wav\isolated_digits_ti_test_endpt\MAN\HC\8B_endpt.wav	mfctest\8_55.mfc
wav\isolated_digits_ti_test_endpt\MAN\HC\9A_endpt.wav	mfctest\9_54.mfc
wav\isolated_digits_ti_test_endpt\MAN\HC\9B_endpt.wav	mfctest\9_55.mfc
wav\isolated_digits_ti_test_endpt\MAN\HC\OA_endpt.wav	mfctest\10_54.mfc
wav\isolated_digits_ti_test_endpt\MAN\HC\OB_endpt.wav	mfctest\10_55.mfc
wav\isolated_digits_ti_test_endpt\MAN\HC\ZA_endpt.wav	mfctest\0_54.mfc
wav\isolated_digits_ti_test_endpt\MAN\HC\ZB_endpt.wav	mfctest\0_55.mfc
wav\isolated_digits_ti_test_endpt\MAN\HJ\1A_endpt.wav	mfctest\1_56.mfc
wav\isolated_digits_ti_test_endpt\MAN\HJ\1B_endpt.wav	mfctest\1_57.mfc
wav\isolated_digits_ti_test_endpt\MAN\HJ\2A_endpt.wav	mfctest\2_56.mfc
wav\isolated_digits_ti_test_endpt\MAN\HJ\2B_endpt.wav	mfctest\2_57.mfc
wav\isolated_digits_ti_test_endpt\MAN\HJ\3A_endpt.wav	mfctest\3_56.mfc
wav\isolated_digits_ti_test_endpt\MAN\HJ\3B_endpt.wav	mfctest\3_57.mfc
wav\isolated_digits_ti_test_endpt\MAN\HJ\4A_endpt.wav	mfctest\4_56.mfc
wav\isolated_digits_ti_test_endpt\MAN\HJ\4B_endpt.wav	mfctest\4_57.mfc
wav\isolated_digits_ti_test_endpt\MAN\HJ\5A_endpt.wav	mfctest\5_56.mfc
wav\isolated_digits_ti_test_endpt\MAN\HJ\5B_endpt.wav	mfctest\5_57.mfc
wav\isolated_digits_ti_test_endpt\MAN\HJ\6A_endpt.wav	mfctest\6_56.mfc
wav\isolated_digits_ti_test_endpt\MAN\HJ\6B_endpt.wav	mfctest\6_57.mfc
wav\isolated_digits_ti_test_endpt\MAN\HJ\7A_endpt.wav	mfctest\7_56.mfc
wav\isolated_digits_ti_test_endpt\MAN\HJ\7B_endpt.wav	mfctest\7_57.mfc
wav\isolated_digits_ti_test_endpt\MAN\HJ\8A_endpt.wav	mfctest\8_56.mfc
wav\isolated_digits_ti_test_endpt\MAN\HJ\8B_endpt.wav	mfctest\8_57.mfc
wav\isolated_digits_ti_test_endpt\MAN\HJ\9A_endpt.wav	mfctest\9_56.mfc
wav\isolated_digits_ti_test_endpt\MAN\HJ\9B_endpt.wav	mfctest\9_57.mfc
wav\isolated_digits_ti_test_endpt\MAN\HJ\OA_endpt.wav	mfctest\10_56.mfc
wav\isolated_digits_ti_test_endpt\MAN\HJ\OB_endpt.wav	mfctest\10_57.mfc
wav\isolated_digits_ti_test_endpt\MAN\HJ\ZA_endpt.wav	mfctest\0_56.mfc
wav\isolated_digits_ti_test_endpt\MAN\HJ\ZB_endpt.wav	mfctest\0_57.mfc
wav\isolated_digits_ti_test_endpt\MAN\HM\1A_endpt.wav	mfctest\1_58.mfc
wav\isolated_digits_ti_test_endpt\MAN\HM\1B_endpt.wav	mfctest\1_59.mfc
wav\isolated_digits_ti_test_endpt\MAN\HM\2A_endpt.wav	mfctest\2_58.mfc
wav\isolated_digits_ti_test_endpt\MAN\HM\2B_endpt.wav	mfctest\2_59.mfc
wav\isolated_digits_ti_test_endpt\MAN\HM\3A_endpt.wav	mfctest\3_58.mfc
wav\isolated_digits_ti_test_endpt\MAN\HM\3B_endpt.wav	mfctest\3_59.mfc
wav\isolated_digits_ti_test_endpt\MAN\HM\4A_endpt.wav	mfctest\4_58.mfc
wav\isolated_digits_ti_test_endpt\MAN\HM\4B_endpt.wav	mfctest\4_59.mfc
wav\isolated_digits_ti_test_endpt\MAN\HM\5A_endpt.wav	mfctest\5_58.mfc
wav\isolated_digits_ti_test_endpt\MAN\HM\5B_endpt.wav	mfctest\5_59.mfc
wav\isolated_digits_ti_test_endpt\MAN\HM\6A_endpt.wav	mfctest\6_58.mfc
wav\isolated_digits_ti_test_endpt\MAN\HM\6B_endpt.wav	mfctest\6_59.mfc
wav\isolated_digits_ti_test_endpt\MAN\HM\7A_endpt.wav	mfctest\7_58.mfc
wav\isolated_digits_ti_test_endpt\MAN\HM\7B_endpt.wav	mfctest\7_59.mfc
wav\isolated_digits_ti_test_endpt\MAN\HM\8A_endpt.wav	mfctest\8_58.mfc
wav\isolated_digits_ti_test_endpt\MAN\HM\8B_endpt.wav	mfctest\8_59.mfc
wav\isolated_digits_ti_test_endpt\MAN\HM\9A_endpt.wav	mfctest\9_58.mfc
wav\isolated_digits_ti_test_endpt\MAN\HM\9B_endpt.wav	mfctest\9_59.mfc
wav\isolated_digits_ti_test_endpt\MAN\HM\OA_endpt.wav	mfctest\10_58.mfc
wav\isolated_digits_ti_test_endpt\MAN\HM\OB_endpt.wav	mfctest\10_59.mfc
wav\isolated_digits_ti_test_endpt\MAN\HM\ZA_endpt.wav	mfctest\0_58.mfc
wav\isolated_digits_ti_test_endpt\MAN\HM\ZB_endpt.wav	mfctest\0_59.mfc
wav\isolated_digits_ti_test_endpt\MAN\HR\1A_endpt.wav	mfctest\1_60.mfc
wav\isolated_digits_ti_test_endpt\MAN\HR\1B_endpt.wav	mfctest\1_61.mfc
wav\isolated_digits_ti_test_endpt\MAN\HR\2A_endpt.wav	mfctest\2_60.mfc
wav\isolated_digits_ti_test_endpt\MAN\HR\2B_endpt.wav	mfctest\2_61.mfc
wav\isolated_digits_ti_test_endpt\MAN\HR\3A_endpt.wav	mfctest\3_60.mfc
wav\isolated_digits_ti_test_endpt\MAN\HR\3B_endpt.wav	mfctest\3_61.mfc
wav\isolated_digits_ti_test_endpt\MAN\HR\4A_endpt.wav	mfctest\4_60.mfc
wav\isolated_digits_ti_test_endpt\MAN\HR\4B_endpt.wav	mfctest\4_61.mfc
wav\isolated_digits_ti_test_endpt\MAN\HR\5A_endpt.wav	mfctest\5_60.mfc
wav\isolated_digits_ti_test_endpt\MAN\HR\5B_endpt.wav	mfctest\5_61.mfc
wav\isolated_digits_ti_test_endpt\MAN\HR\6A_endpt.wav	mfctest\6_60.mfc
wav\isolated_digits_ti_test_endpt\MAN\HR\6B_endpt.wav	mfctest\6_61.mfc
wav\isolated_digits_ti_test_endpt\MAN\HR\7A_endpt.wav	mfctest\7_60.mfc
wav\isolated_digits_ti_test_endpt\MAN\HR\7B_endpt.wav	mfctest\7_61.mfc
wav\isolated_digits_ti_test_endpt\MAN\HR\8A_endpt.wav	mfctest\8_60.mfc
wav\isolated_digits_ti_test_endpt\MAN\HR\8B_endpt.wav	mfctest\8_61.mfc
wav\isolated_digits_ti_test_endpt\MAN\HR\9A_endpt.wav	mfctest\9_60.mfc
wav\isolated_digits_ti_test_endpt\MAN\HR\9B_endpt.wav	mfctest\9_61.mfc
wav\isolated_digits_ti_test_endpt\MAN\HR\OA_endpt.wav	mfctest\10_60.mfc
wav\isolated_digits_ti_test_endpt\MAN\HR\OB_endpt.wav	mfctest\10_61.mfc
wav\isolated_digits_ti_test_endpt\MAN\HR\ZA_endpt.wav	mfctest\0_60.mfc
wav\isolated_digits_ti_test_endpt\MAN\HR\ZB_endpt.wav	mfctest\0_61.mfc
wav\isolated_digits_ti_test_endpt\MAN\IA\1A_endpt.wav	mfctest\1_62.mfc
wav\isolated_digits_ti_test_endpt\MAN\IA\1B_endpt.wav	mfctest\1_63.mfc
wav\isolated_digits_ti_test_endpt\MAN\IA\2A_endpt.wav	mfctest\2_62.mfc
wav\isolated_digits_ti_test_endpt\MAN\IA\2B_endpt.wav	mfctest\2_63.mfc
wav\isolated_digits_ti_test_endpt\MAN\IA\3A_endpt.wav	mfctest\3_62.mfc
wav\isolated_digits_ti_test_endpt\MAN\IA\3B_endpt.wav	mfctest\3_63.mfc
wav\isolated_digits_ti_test_endpt\MAN\IA\4A_endpt.wav	mfctest\4_62.mfc
wav\isolated_digits_ti_test_endpt\MAN\IA\4B_endpt.wav	mfctest\4_63.mfc
wav\isolated_digits_ti_test_endpt\MAN\IA\5A_endpt.wav	mfctest\5_62.mfc
wav\isolated_digits_ti_test_endpt\MAN\IA\5B_endpt.wav	mfctest\5_63.mfc
wav\isolated_digits_ti_test_endpt\MAN\IA\6A_endpt.wav	mfctest\6_62.mfc
wav\isolated_digits_ti_test_endpt\MAN\IA\6B_endpt.wav	mfctest\6_63.mfc
wav\isolated_digits_ti_test_endpt\MAN\IA\7A_endpt.wav	mfctest\7_62.mfc
wav\isolated_digits_ti_test_endpt\MAN\IA\7B_endpt.wav	mfctest\7_63.mfc
wav\isolated_digits_ti_test_endpt\MAN\IA\8A_endpt.wav	mfctest\8_62.mfc
wav\isolated_digits_ti_test_endpt\MAN\IA\8B_endpt.wav	mfctest\8_63.mfc
wav\isolated_digits_ti_test_endpt\MAN\IA\9A_endpt.wav	mfctest\9_62.mfc
wav\isolated_digits_ti_test_endpt\MAN\IA\9B_endpt.wav	mfctest\9_63.mfc
wav\isolated_digits_ti_test_endpt\MAN\IA\OA_endpt.wav	mfctest\10_62.mfc
wav\isolated_digits_ti_test_endpt\MAN\IA\OB_endpt.wav	mfctest\10_63.mfc
wav\isolated_digits_ti_test_endpt\MAN\IA\ZA_endpt.wav	mfctest\0_62.mfc
wav\isolated_digits_ti_test_endpt\MAN\IA\ZB_endpt.wav	mfctest\0_63.mfc
wav\isolated_digits_ti_test_endpt\MAN\IB\1A_endpt.wav	mfctest\1_64.mfc
wav\isolated_digits_ti_test_endpt\MAN\IB\1B_endpt.wav	mfctest\1_65.mfc
wav\isolated_digits_ti_test_endpt\MAN\IB\2A_endpt.wav	mfctest\2_64.mfc
wav\isolated_digits_ti_test_endpt\MAN\IB\2B_endpt.wav	mfctest\2_65.mfc
wav\isolated_digits_ti_test_endpt\MAN\IB\3A_endpt.wav	mfctest\3_64.mfc
wav\isolated_digits_ti_test_endpt\MAN\IB\3B_endpt.wav	mfctest\3_65.mfc
wav\isolated_digits_ti_test_endpt\MAN\IB\4A_endpt.wav	mfctest\4_64.mfc
wav\isolated_digits_ti_test_endpt\MAN\IB\4B_endpt.wav	mfctest\4_65.mfc
wav\isolated_digits_ti_test_endpt\MAN\IB\5A_endpt.wav	mfctest\5_64.mfc
wav\isolated_digits_ti_test_endpt\MAN\IB\5B_endpt.wav	mfctest\5_65.mfc
wav\isolated_digits_ti_test_endpt\MAN\IB\6A_endpt.wav	mfctest\6_64.mfc
wav\isolated_digits_ti_test_endpt\MAN\IB\6B_endpt.wav	mfctest\6_65.mfc
wav\isolated_digits_ti_test_endpt\MAN\IB\7A_endpt.wav	mfctest\7_64.mfc
wav\isolated_digits_ti_test_endpt\MAN\IB\7B_endpt.wav	mfctest\7_65.mfc
wav\isolated_digits_ti_test_endpt\MAN\IB\8A_endpt.wav	mfctest\8_64.mfc
wav\isolated_digits_ti_test_endpt\MAN\IB\8B_endpt.wav	mfctest\8_65.mfc
wav\isolated_digits_ti_test_endpt\MAN\IB\9A_endpt.wav	mfctest\9_64.mfc
wav\isolated_digits_ti_test_endpt\MAN\IB\9B_endpt.wav	mfctest\9_65.mfc
wav\isolated_digits_ti_test_endpt\MAN\IB\OA_endpt.wav	mfctest\10_64.mfc
wav\isolated_digits_ti_test_endpt\MAN\IB\OB_endpt.wav	mfctest\10_65.mfc
wav\isolated_digits_ti_test_endpt\MAN\IB\ZA_endpt.wav	mfctest\0_64.mfc
wav\isolated_digits_ti_test_endpt\MAN\IB\ZB_endpt.wav	mfctest\0_65.mfc
wav\isolated_digits_ti_test_endpt\MAN\IM\1A_endpt.wav	mfctest\1_66.mfc
wav\isolated_digits_ti_test_endpt\MAN\IM\1B_endpt.wav	mfctest\1_67.mfc
wav\isolated_digits_ti_test_endpt\MAN\IM\2A_endpt.wav	mfctest\2_66.mfc
wav\isolated_digits_ti_test_endpt\MAN\IM\2B_endpt.wav	mfctest\2_67.mfc
wav\isolated_digits_ti_test_endpt\MAN\IM\3A_endpt.wav	mfctest\3_66.mfc
wav\isolated_digits_ti_test_endpt\MAN\IM\3B_endpt.wav	mfctest\3_67.mfc
wav\isolated_digits_ti_test_endpt\MAN\IM\4A_endpt.wav	mfctest\4_66.mfc
wav\isolated_digits_ti_test_endpt\MAN\IM\4B_endpt.wav	mfctest\4_67.mfc
wav\isolated_digits_ti_test_endpt\MAN\IM\5A_endpt.wav	mfctest\5_66.mfc
wav\isolated_digits_ti_test_endpt\MAN\IM\5B_endpt.wav	mfctest\5_67.mfc
wav\isolated_digits_ti_test_endpt\MAN\IM\6A_endpt.wav	mfctest\6_66.mfc
wav\isolated_digits_ti_test_endpt\MAN\IM\6B_endpt.wav	mfctest\6_67.mfc
wav\isolated_digits_ti_test_endpt\MAN\IM\7A_endpt.wav	mfctest\7_66.mfc
wav\isolated_digits_ti_test_endpt\MAN\IM\7B_endpt.wav	mfctest\7_67.mfc
wav\isolated_digits_ti_test_endpt\MAN\IM\8A_endpt.wav	mfctest\8_66.mfc
wav\isolated_digits_ti_test_endpt\MAN\IM\8B_endpt.wav	mfctest\8_67.mfc
wav\isolated_digits_ti_test_endpt\MAN\IM\9A_endpt.wav	mfctest\9_66.mfc
wav\isolated_digits_ti_test_endpt\MAN\IM\9B_endpt.wav	mfctest\9_67.mfc
wav\isolated_digits_ti_test_endpt\MAN\IM\OA_endpt.wav	mfctest\10_66.mfc
wav\isolated_digits_ti_test_endpt\MAN\IM\OB_endpt.wav	mfctest\10_67.mfc
wav\isolated_digits_ti_test_endpt\MAN\IM\ZA_endpt.wav	mfctest\0_66.mfc
wav\isolated_digits_ti_test_endpt\MAN\IM\ZB_endpt.wav	mfctest\0_67.mfc
wav\isolated_digits_ti_test_endpt\MAN\IP\1A_endpt.wav	mfctest\1_68.mfc
wav\isolated_digits_ti_test_endpt\MAN\IP\1B_endpt.wav	mfctest\1_69.mfc
wav\isolated_digits_ti_test_endpt\MAN\IP\2A_endpt.wav	mfctest\2_68.mfc
wav\isolated_digits_ti_test_endpt\MAN\IP\2B_endpt.wav	mfctest\2_69.mfc
wav\isolated_digits_ti_test_endpt\MAN\IP\3A_endpt.wav	mfctest\3_68.mfc
wav\isolated_digits_ti_test_endpt\MAN\IP\3B_endpt.wav	mfctest\3_69.mfc
wav\isolated_digits_ti_test_endpt\MAN\IP\4A_endpt.wav	mfctest\4_68.mfc
wav\isolated_digits_ti_test_endpt\MAN\IP\4B_endpt.wav	mfctest\4_69.mfc
wav\isolated_digits_ti_test_endpt\MAN\IP\5A_endpt.wav	mfctest\5_68.mfc
wav\isolated_digits_ti_test_endpt\MAN\IP\5B_endpt.wav	mfctest\5_69.mfc
wav\isolated_digits_ti_test_endpt\MAN\IP\6A_endpt.wav	mfctest\6_68.mfc
wav\isolated_digits_ti_test_endpt\MAN\IP\6B_endpt.wav	mfctest\6_69.mfc
wav\isolated_digits_ti_test_endpt\MAN\IP\7A_endpt.wav	mfctest\7_68.mfc
wav\isolated_digits_ti_test_endpt\MAN\IP\7B_endpt.wav	mfctest\7_69.mfc
wav\isolated_digits_ti_test_endpt\MAN\IP\8A_endpt.wav	mfctest\8_68.mfc
wav\isolated_digits_ti_test_endpt\MAN\IP\8B_endpt.wav	mfctest\8_69.mfc
wav\isolated_digits_ti_test_endpt\MAN\IP\9A_endpt.wav	mfctest\9_68.mfc
wav\isolated_digits_ti_test_endpt\MAN\IP\9B_endpt.wav	mfctest\9_69.mfc
wav\isolated_digits_ti_test_endpt\MAN\IP\OA_endpt.wav	mfctest\10_68.mfc
wav\isolated_digits_ti_test_endpt\MAN\IP\OB_endpt.wav	mfctest\10_69.mfc
wav\isolated_digits_ti_test_endpt\MAN\IP\ZA_endpt.wav	mfctest\0_68.mfc
wav\isolated_digits_ti_test_endpt\MAN\IP\ZB_endpt.wav	mfctest\0_69.mfc
wav\isolated_digits_ti_test_endpt\MAN\JA\1A_endpt.wav	mfctest\1_70.mfc
wav\isolated_digits_ti_test_endpt\MAN\JA\1B_endpt.wav	mfctest\1_71.mfc
wav\isolated_digits_ti_test_endpt\MAN\JA\2A_endpt.wav	mfctest\2_70.mfc
wav\isolated_digits_ti_test_endpt\MAN\JA\2B_endpt.wav	mfctest\2_71.mfc
wav\isolated_digits_ti_test_endpt\MAN\JA\3A_endpt.wav	mfctest\3_70.mfc
wav\isolated_digits_ti_test_endpt\MAN\JA\3B_endpt.wav	mfctest\3_71.mfc
wav\isolated_digits_ti_test_endpt\MAN\JA\4A_endpt.wav	mfctest\4_70.mfc
wav\isolated_digits_ti_test_endpt\MAN\JA\4B_endpt.wav	mfctest\4_71.mfc
wav\isolated_digits_ti_test_endpt\MAN\JA\5A_endpt.wav	mfctest\5_70.mfc
wav\isolated_digits_ti_test_endpt\MAN\JA\5B_endpt.wav	mfctest\5_71.mfc
wav\isolated_digits_ti_test_endpt\MAN\JA\6A_endpt.wav	mfctest\6_70.mfc
wav\isolated_digits_ti_test_endpt\MAN\JA\6B_endpt.wav	mfctest\6_71.mfc
wav\isolated_digits_ti_test_endpt\MAN\JA\7A_endpt.wav	mfctest\7_70.mfc
wav\isolated_digits_ti_test_endpt\MAN\JA\7B_endpt.wav	mfctest\7_71.mfc
wav\isolated_digits_ti_test_endpt\MAN\JA\8A_endpt.wav	mfctest\8_70.mfc
wav\isolated_digits_ti_test_endpt\MAN\JA\8B_endpt.wav	mfctest\8_71.mfc
wav\isolated_digits_ti_test_endpt\MAN\JA\9A_endpt.wav	mfctest\9_70.mfc
wav\isolated_digits_ti_test_endpt\MAN\JA\9B_endpt.wav	mfctest\9_71.mfc
wav\isolated_digits_ti_test_endpt\MAN\JA\OA_endpt.wav	mfctest\10_70.mfc
wav\isolated_digits_ti_test_endpt\MAN\JA\OB_endpt.wav	mfctest\10_71.mfc
wav\isolated_digits_ti_test_endpt\MAN\JA\ZA_endpt.wav	mfctest\0_70.mfc
wav\isolated_digits_ti_test_endpt\MAN\JA\ZB_endpt.wav	mfctest\0_71.mfc
wav\isolated_digits_ti_test_endpt\MAN\JH\1A_endpt.wav	mfctest\1_72.mfc
wav\isolated_digits_ti_test_endpt\MAN\JH\1B_endpt.wav	mfctest\1_73.mfc
wav\isolated_digits_ti_test_endpt\MAN\JH\2A_endpt.wav	mfctest\2_72.mfc
wav\isolated_digits_ti_test_endpt\MAN\JH\2B_endpt.wav	mfctest\2_73.mfc
wav\isolated_digits_ti_test_endpt\MAN\JH\3A_endpt.wav	mfctest\3_72.mfc
wav\isolated_digits_ti_test_endpt\MAN\JH\3B_endpt.wav	mfctest\3_73.mfc
wav\isolated_digits_ti_test_endpt\MAN\JH\4A_endpt.wav	mfctest\4_72.mfc
wav\isolated_digits_ti_test_endpt\MAN\JH\4B_endpt.wav	mfctest\4_73.mfc
wav\isolated_digits_ti_test_endpt\MAN\JH\5A_endpt.wav	mfctest\5_72.mfc
wav\isolated_digits_ti_test_endpt\MAN\JH\5B_endpt.wav	mfctest\5_73.mfc
wav\isolated_digits_ti_test_endpt\MAN\JH\6A_endpt.wav	mfctest\6_72.mfc
wav\isolated_digits_ti_test_endpt\MAN\JH\6B_endpt.wav	mfctest\6_73.mfc
wav\isolated_digits_ti_test_endpt\MAN\JH\7A_endpt.wav	mfctest\7_72.mfc
wav\isolated_digits_ti_test_endpt\MAN\JH\7B_endpt.wav	mfctest\7_73.mfc
wav\isolated_digits_ti_test_endpt\MAN\JH\8A_endpt.wav	mfctest\8_72.mfc
wav\isolated_digits_ti_test_endpt\MAN\JH\8B_endpt.wav	mfctest\8_73.mfc
wav\isolated_digits_ti_test_endpt\MAN\JH\9A_endpt.wav	mfctest\9_72.mfc
wav\isolated_digits_ti_test_endpt\MAN\JH\9B_endpt.wav	mfctest\9_73.mfc
wav\isolated_digits_ti_test_endpt\MAN\JH\OA_endpt.wav	mfctest\10_72.mfc
wav\isolated_digits_ti_test_endpt\MAN\JH\OB_endpt.wav	mfctest\10_73.mfc
wav\isolated_digits_ti_test_endpt\MAN\JH\ZA_endpt.wav	mfctest\0_72.mfc
wav\isolated_digits_ti_test_endpt\MAN\JH\ZB_endpt.wav	mfctest\0_73.mfc
wav\isolated_digits_ti_test_endpt\MAN\KA\1A_endpt.wav	mfctest\1_74.mfc
wav\isolated_digits_ti_test_endpt\MAN\KA\1B_endpt.wav	mfctest\1_75.mfc
wav\isolated_digits_ti_test_endpt\MAN\KA\2A_endpt.wav	mfctest\2_74.mfc
wav\isolated_digits_ti_test_endpt\MAN\KA\2B_endpt.wav	mfctest\2_75.mfc
wav\isolated_digits_ti_test_endpt\MAN\KA\3A_endpt.wav	mfctest\3_74.mfc
wav\isolated_digits_ti_test_endpt\MAN\KA\3B_endpt.wav	mfctest\3_75.mfc
wav\isolated_digits_ti_test_endpt\MAN\KA\4A_endpt.wav	mfctest\4_74.mfc
wav\isolated_digits_ti_test_endpt\MAN\KA\4B_endpt.wav	mfctest\4_75.mfc
wav\isolated_digits_ti_test_endpt\MAN\KA\5A_endpt.wav	mfctest\5_74.mfc
wav\isolated_digits_ti_test_endpt\MAN\KA\5B_endpt.wav	mfctest\5_75.mfc
wav\isolated_digits_ti_test_endpt\MAN\KA\6A_endpt.wav	mfctest\6_74.mfc
wav\isolated_digits_ti_test_endpt\MAN\KA\6B_endpt.wav	mfctest\6_75.mfc
wav\isolated_digits_ti_test_endpt\MAN\KA\7A_endpt.wav	mfctest\7_74.mfc
wav\isolated_digits_ti_test_endpt\MAN\KA\7B_endpt.wav	mfctest\7_75.mfc
wav\isolated_digits_ti_test_endpt\MAN\KA\8A_endpt.wav	mfctest\8_74.mfc
wav\isolated_digits_ti_test_endpt\MAN\KA\8B_endpt.wav	mfctest\8_75.mfc
wav\isolated_digits_ti_test_endpt\MAN\KA\9A_endpt.wav	mfctest\9_74.mfc
wav\isolated_digits_ti_test_endpt\MAN\KA\9B_endpt.wav	mfctest\9_75.mfc
wav\isolated_digits_ti_test_endpt\MAN\KA\OA_endpt.wav	mfctest\10_74.mfc
wav\isolated_digits_ti_test_endpt\MAN\KA\OB_endpt.wav	mfctest\10_75.mfc
wav\isolated_digits_ti_test_endpt\MAN\KA\ZA_endpt.wav	mfctest\0_74.mfc
wav\isolated_digits_ti_test_endpt\MAN\KA\ZB_endpt.wav	mfctest\0_75.mfc
wav\isolated_digits_ti_test_endpt\MAN\KE\1A_endpt.wav	mfctest\1_76.mfc
wav\isolated_digits_ti_test_endpt\MAN\KE\1B_endpt.wav	mfctest\1_77.mfc
wav\isolated_digits_ti_test_endpt\MAN\KE\2A_endpt.wav	mfctest\2_76.mfc
wav\isolated_digits_ti_test_endpt\MAN\KE\2B_endpt.wav	mfctest\2_77.mfc
wav\isolated_digits_ti_test_endpt\MAN\KE\3A_endpt.wav	mfctest\3_76.mfc
wav\isolated_digits_ti_test_endpt\MAN\KE\3B_endpt.wav	mfctest\3_77.mfc
wav\isolated_digits_ti_test_endpt\MAN\KE\4A_endpt.wav	mfctest\4_76.mfc
wav\isolated_digits_ti_test_endpt\MAN\KE\4B_endpt.wav	mfctest\4_77.mfc
wav\isolated_digits_ti_test_endpt\MAN\KE\5A_endpt.wav	mfctest\5_76.mfc
wav\isolated_digits_ti_test_endpt\MAN\KE\5B_endpt.wav	mfctest\5_77.mfc
wav\isolated_digits_ti_test_endpt\MAN\KE\6A_endpt.wav	mfctest\6_76.mfc
wav\isolated_digits_ti_test_endpt\MAN\KE\6B_endpt.wav	mfctest\6_77.mfc
wav\isolated_digits_ti_test_endpt\MAN\KE\7A_endpt.wav	mfctest\7_76.mfc
wav\isolated_digits_ti_test_endpt\MAN\KE\7B_endpt.wav	mfctest\7_77.mfc
wav\isolated_digits_ti_test_endpt\MAN\KE\8A_endpt.wav	mfctest\8_76.mfc
wav\isolated_digits_ti_test_endpt\MAN\KE\8B_endpt.wav	mfctest\8_77.mfc
wav\isolated_digits_ti_test_endpt\MAN\KE\9A_endpt.wav	mfctest\9_76.mfc
wav\isolated_digits_ti_test_endpt\MAN\KE\9B_endpt.wav	mfctest\9_77.mfc
wav\isolated_digits_ti_test_endpt\MAN\KE\OA_endpt.wav	mfctest\10_76.mfc
wav\isolated_digits_ti_test_endpt\MAN\KE\OB_endpt.wav	mfctest\10_77.mfc
wav\isolated_digits_ti_test_endpt\MAN\KE\ZA_endpt.wav	mfctest\0_76.mfc
wav\isolated_digits_ti_test_endpt\MAN\KE\ZB_endpt.wav	mfctest\0_77.mfc
wav\isolated_digits_ti_test_endpt\MAN\KG\1A_endpt.wav	mfctest\1_78.mfc
wav\isolated_digits_ti_test_endpt\MAN\KG\1B_endpt.wav	mfctest\1_79.mfc
wav\isolated_digits_ti_test_endpt\MAN\KG\2A_endpt.wav	mfctest\2_78.mfc
wav\isolated_digits_ti_test_endpt\MAN\KG\2B_endpt.wav	mfctest\2_79.mfc
wav\isolated_digits_ti_test_endpt\MAN\KG\3A_endpt.wav	mfctest\3_78.mfc
wav\isolated_digits_ti_test_endpt\MAN\KG\3B_endpt.wav	mfctest\3_79.mfc
wav\isolated_digits_ti_test_endpt\MAN\KG\4A_endpt.wav	mfctest\4_78.mfc
wav\isolated_digits_ti_test_endpt\MAN\KG\4B_endpt.wav	mfctest\4_79.mfc
wav\isolated_digits_ti_test_endpt\MAN\KG\5A_endpt.wav	mfctest\5_78.mfc
wav\isolated_digits_ti_test_endpt\MAN\KG\5B_endpt.wav	mfctest\5_79.mfc
wav\isolated_digits_ti_test_endpt\MAN\KG\6A_endpt.wav	mfctest\6_78.mfc
wav\isolated_digits_ti_test_endpt\MAN\KG\6B_endpt.wav	mfctest\6_79.mfc
wav\isolated_digits_ti_test_endpt\MAN\KG\7A_endpt.wav	mfctest\7_78.mfc
wav\isolated_digits_ti_test_endpt\MAN\KG\7B_endpt.wav	mfctest\7_79.mfc
wav\isolated_digits_ti_test_endpt\MAN\KG\8A_endpt.wav	mfctest\8_78.mfc
wav\isolated_digits_ti_test_endpt\MAN\KG\8B_endpt.wav	mfctest\8_79.mfc
wav\isolated_digits_ti_test_endpt\MAN\KG\9A_endpt.wav	mfctest\9_78.mfc
wav\isolated_digits_ti_test_endpt\MAN\KG\9B_endpt.wav	mfctest\9_79.mfc
wav\isolated_digits_ti_test_endpt\MAN\KG\OA_endpt.wav	mfctest\10_78.mfc
wav\isolated_digits_ti_test_endpt\MAN\KG\OB_endpt.wav	mfctest\10_79.mfc
wav\isolated_digits_ti_test_endpt\MAN\KG\ZA_endpt.wav	mfctest\0_78.mfc
wav\isolated_digits_ti_test_endpt\MAN\KG\ZB_endpt.wav	mfctest\0_79.mfc
wav\isolated_digits_ti_test_endpt\MAN\LE\1A_endpt.wav	mfctest\1_80.mfc
wav\isolated_digits_ti_test_endpt\MAN\LE\1B_endpt.wav	mfctest\1_81.mfc
wav\isolated_digits_ti_test_endpt\MAN\LE\2A_endpt.wav	mfctest\2_80.mfc
wav\isolated_digits_ti_test_endpt\MAN\LE\2B_endpt.wav	mfctest\2_81.mfc
wav\isolated_digits_ti_test_endpt\MAN\LE\3A_endpt.wav	mfctest\3_80.mfc
wav\isolated_digits_ti_test_endpt\MAN\LE\3B_endpt.wav	mfctest\3_81.mfc
wav\isolated_digits_ti_test_endpt\MAN\LE\4A_endpt.wav	mfctest\4_80.mfc
wav\isolated_digits_ti_test_endpt\MAN\LE\4B_endpt.wav	mfctest\4_81.mfc
wav\isolated_digits_ti_test_endpt\MAN\LE\5A_endpt.wav	mfctest\5_80.mfc
wav\isolated_digits_ti_test_endpt\MAN\LE\5B_endpt.wav	mfctest\5_81.mfc
wav\isolated_digits_ti_test_endpt\MAN\LE\6A_endpt.wav	mfctest\6_80.mfc
wav\isolated_digits_ti_test_endpt\MAN\LE\6B_endpt.wav	mfctest\6_81.mfc
wav\isolated_digits_ti_test_endpt\MAN\LE\7A_endpt.wav	mfctest\7_80.mfc
wav\isolated_digits_ti_test_endpt\MAN\LE\7B_endpt.wav	mfctest\7_81.mfc
wav\isolated_digits_ti_test_endpt\MAN\LE\8A_endpt.wav	mfctest\8_80.mfc
wav\isolated_digits_ti_test_endpt\MAN\LE\8B_endpt.wav	mfctest\8_81.mfc
wav\isolated_digits_ti_test_endpt\MAN\LE\9A_endpt.wav	mfctest\9_80.mfc
wav\isolated_digits_ti_test_endpt\MAN\LE\9B_endpt.wav	mfctest\9_81.mfc
wav\isolated_digits_ti_test_endpt\MAN\LE\OA_endpt.wav	mfctest\10_80.mfc
wav\isolated_digits_ti_test_endpt\MAN\LE\OB_endpt.wav	mfctest\10_81.mfc
wav\isolated_digits_ti_test_endpt\MAN\LE\ZA_endpt.wav	mfctest\0_80.mfc
wav\isolated_digits_ti_test_endpt\MAN\LE\ZB_endpt.wav	mfctest\0_81.mfc
wav\isolated_digits_ti_test_endpt\MAN\LG\1A_endpt.wav	mfctest\1_82.mfc
wav\isolated_digits_ti_test_endpt\MAN\LG\1B_endpt.wav	mfctest\1_83.mfc
wav\isolated_digits_ti_test_endpt\MAN\LG\2A_endpt.wav	mfctest\2_82.mfc
wav\isolated_digits_ti_test_endpt\MAN\LG\2B_endpt.wav	mfctest\2_83.mfc
wav\isolated_digits_ti_test_endpt\MAN\LG\3A_endpt.wav	mfctest\3_82.mfc
wav\isolated_digits_ti_test_endpt\MAN\LG\3B_endpt.wav	mfctest\3_83.mfc
wav\isolated_digits_ti_test_endpt\MAN\LG\4A_endpt.wav	mfctest\4_82.mfc
wav\isolated_digits_ti_test_endpt\MAN\LG\4B_endpt.wav	mfctest\4_83.mfc
wav\isolated_digits_ti_test_endpt\MAN\LG\5A_endpt.wav	mfctest\5_82.mfc
wav\isolated_digits_ti_test_endpt\MAN\LG\5B_endpt.wav	mfctest\5_83.mfc
wav\isolated_digits_ti_test_endpt\MAN\LG\6A_endpt.wav	mfctest\6_82.mfc
wav\isolated_digits_ti_test_endpt\MAN\LG\6B_endpt.wav	mfctest\6_83.mfc
wav\isolated_digits_ti_test_endpt\MAN\LG\7A_endpt.wav	mfctest\7_82.mfc
wav\isolated_digits_ti_test_endpt\MAN\LG\7B_endpt.wav	mfctest\7_83.mfc
wav\isolated_digits_ti_test_endpt\MAN\LG\8A_endpt.wav	mfctest\8_82.mfc
wav\isolated_digits_ti_test_endpt\MAN\LG\8B_endpt.wav	mfctest\8_83.mfc
wav\isolated_digits_ti_test_endpt\MAN\LG\9A_endpt.wav	mfctest\9_82.mfc
wav\isolated_digits_ti_test_endpt\MAN\LG\9B_endpt.wav	mfctest\9_83.mfc
wav\isolated_digits_ti_test_endpt\MAN\LG\OA_endpt.wav	mfctest\10_82.mfc
wav\isolated_digits_ti_test_endpt\MAN\LG\OB_endpt.wav	mfctest\10_83.mfc
wav\isolated_digits_ti_test_endpt\MAN\LG\ZA_endpt.wav	mfctest\0_82.mfc
wav\isolated_digits_ti_test_endpt\MAN\LG\ZB_endpt.wav	mfctest\0_83.mfc
wav\isolated_digits_ti_test_endpt\MAN\MI\1A_endpt.wav	mfctest\1_84.mfc
wav\isolated_digits_ti_test_endpt\MAN\MI\1B_endpt.wav	mfctest\1_85.mfc
wav\isolated_digits_ti_test_endpt\MAN\MI\2A_endpt.wav	mfctest\2_84.mfc
wav\isolated_digits_ti_test_endpt\MAN\MI\2B_endpt.wav	mfctest\2_85.mfc
wav\isolated_digits_ti_test_endpt\MAN\MI\3A_endpt.wav	mfctest\3_84.mfc
wav\isolated_digits_ti_test_endpt\MAN\MI\3B_endpt.wav	mfctest\3_85.mfc
wav\isolated_digits_ti_test_endpt\MAN\MI\4A_endpt.wav	mfctest\4_84.mfc
wav\isolated_digits_ti_test_endpt\MAN\MI\4B_endpt.wav	mfctest\4_85.mfc
wav\isolated_digits_ti_test_endpt\MAN\MI\5A_endpt.wav	mfctest\5_84.mfc
wav\isolated_digits_ti_test_endpt\MAN\MI\5B_endpt.wav	mfctest\5_85.mfc
wav\isolated_digits_ti_test_endpt\MAN\MI\6A_endpt.wav	mfctest\6_84.mfc
wav\isolated_digits_ti_test_endpt\MAN\MI\6B_endpt.wav	mfctest\6_85.mfc
wav\isolated_digits_ti_test_endpt\MAN\MI\7A_endpt.wav	mfctest\7_84.mfc
wav\isolated_digits_ti_test_endpt\MAN\MI\7B_endpt.wav	mfctest\7_85.mfc
wav\isolated_digits_ti_test_endpt\MAN\MI\8A_endpt.wav	mfctest\8_84.mfc
wav\isolated_digits_ti_test_endpt\MAN\MI\8B_endpt.wav	mfctest\8_85.mfc
wav\isolated_digits_ti_test_endpt\MAN\MI\9A_endpt.wav	mfctest\9_84.mfc
wav\isolated_digits_ti_test_endpt\MAN\MI\9B_endpt.wav	mfctest\9_85.mfc
wav\isolated_digits_ti_test_endpt\MAN\MI\OA_endpt.wav	mfctest\10_84.mfc
wav\isolated_digits_ti_test_endpt\MAN\MI\OB_endpt.wav	mfctest\10_85.mfc
wav\isolated_digits_ti_test_endpt\MAN\MI\ZA_endpt.wav	mfctest\0_84.mfc
wav\isolated_digits_ti_test_endpt\MAN\MI\ZB_endpt.wav	mfctest\0_85.mfc
wav\isolated_digits_ti_test_endpt\MAN\NL\1A_endpt.wav	mfctest\1_86.mfc
wav\isolated_digits_ti_test_endpt\MAN\NL\1B_endpt.wav	mfctest\1_87.mfc
wav\isolated_digits_ti_test_endpt\MAN\NL\2A_endpt.wav	mfctest\2_86.mfc
wav\isolated_digits_ti_test_endpt\MAN\NL\2B_endpt.wav	mfctest\2_87.mfc
wav\isolated_digits_ti_test_endpt\MAN\NL\3A_endpt.wav	mfctest\3_86.mfc
wav\isolated_digits_ti_test_endpt\MAN\NL\3B_endpt.wav	mfctest\3_87.mfc
wav\isolated_digits_ti_test_endpt\MAN\NL\4A_endpt.wav	mfctest\4_86.mfc
wav\isolated_digits_ti_test_endpt\MAN\NL\4B_endpt.wav	mfctest\4_87.mfc
wav\isolated_digits_ti_test_endpt\MAN\NL\5A_endpt.wav	mfctest\5_86.mfc
wav\isolated_digits_ti_test_endpt\MAN\NL\5B_endpt.wav	mfctest\5_87.mfc
wav\isolated_digits_ti_test_endpt\MAN\NL\6A_endpt.wav	mfctest\6_86.mfc
wav\isolated_digits_ti_test_endpt\MAN\NL\6B_endpt.wav	mfctest\6_87.mfc
wav\isolated_digits_ti_test_endpt\MAN\NL\7A_endpt.wav	mfctest\7_86.mfc
wav\isolated_digits_ti_test_endpt\MAN\NL\7B_endpt.wav	mfctest\7_87.mfc
wav\isolated_digits_ti_test_endpt\MAN\NL\8A_endpt.wav	mfctest\8_86.mfc
wav\isolated_digits_ti_test_endpt\MAN\NL\8B_endpt.wav	mfctest\8_87.mfc
wav\isolated_digits_ti_test_endpt\MAN\NL\9A_endpt.wav	mfctest\9_86.mfc
wav\isolated_digits_ti_test_endpt\MAN\NL\9B_endpt.wav	mfctest\9_87.mfc
wav\isolated_digits_ti_test_endpt\MAN\NL\OA_endpt.wav	mfctest\10_86.mfc
wav\isolated_digits_ti_test_endpt\MAN\NL\OB_endpt.wav	mfctest\10_87.mfc
wav\isolated_digits_ti_test_endpt\MAN\NL\ZA_endpt.wav	mfctest\0_86.mfc
wav\isolated_digits_ti_test_endpt\MAN\NL\ZB_endpt.wav	mfctest\0_87.mfc
wav\isolated_digits_ti_test_endpt\MAN\NP\1A_endpt.wav	mfctest\1_88.mfc
wav\isolated_digits_ti_test_endpt\MAN\NP\1B_endpt.wav	mfctest\1_89.mfc
wav\isolated_digits_ti_test_endpt\MAN\NP\2A_endpt.wav	mfctest\2_88.mfc
wav\isolated_digits_ti_test_endpt\MAN\NP\2B_endpt.wav	mfctest\2_89.mfc
wav\isolated_digits_ti_test_endpt\MAN\NP\3A_endpt.wav	mfctest\3_88.mfc
wav\isolated_digits_ti_test_endpt\MAN\NP\3B_endpt.wav	mfctest\3_89.mfc
wav\isolated_digits_ti_test_endpt\MAN\NP\4A_endpt.wav	mfctest\4_88.mfc
wav\isolated_digits_ti_test_endpt\MAN\NP\4B_endpt.wav	mfctest\4_89.mfc
wav\isolated_digits_ti_test_endpt\MAN\NP\5A_endpt.wav	mfctest\5_88.mfc
wav\isolated_digits_ti_test_endpt\MAN\NP\5B_endpt.wav	mfctest\5_89.mfc
wav\isolated_digits_ti_test_endpt\MAN\NP\6A_endpt.wav	mfctest\6_88.mfc
wav\isolated_digits_ti_test_endpt\MAN\NP\6B_endpt.wav	mfctest\6_89.mfc
wav\isolated_digits_ti_test_endpt\MAN\NP\7A_endpt.wav	mfctest\7_88.mfc
wav\isolated_digits_ti_test_endpt\MAN\NP\7B_endpt.wav	mfctest\7_89.mfc
wav\isolated_digits_ti_test_endpt\MAN\NP\8A_endpt.wav	mfctest\8_88.mfc
wav\isolated_digits_ti_test_endpt\MAN\NP\8B_endpt.wav	mfctest\8_89.mfc
wav\isolated_digits_ti_test_endpt\MAN\NP\9A_endpt.wav	mfctest\9_88.mfc
wav\isolated_digits_ti_test_endpt\MAN\NP\9B_endpt.wav	mfctest\9_89.mfc
wav\isolated_digits_ti_test_endpt\MAN\NP\OA_endpt.wav	mfctest\10_88.mfc
wav\isolated_digits_ti_test_endpt\MAN\NP\OB_endpt.wav	mfctest\10_89.mfc
wav\isolated_digits_ti_test_endpt\MAN\NP\ZA_endpt.wav	mfctest\0_88.mfc
wav\isolated_digits_ti_test_endpt\MAN\NP\ZB_endpt.wav	mfctest\0_89.mfc
wav\isolated_digits_ti_test_endpt\MAN\NT\1A_endpt.wav	mfctest\1_90.mfc
wav\isolated_digits_ti_test_endpt\MAN\NT\1B_endpt.wav	mfctest\1_91.mfc
wav\isolated_digits_ti_test_endpt\MAN\NT\2A_endpt.wav	mfctest\2_90.mfc
wav\isolated_digits_ti_test_endpt\MAN\NT\2B_endpt.wav	mfctest\2_91.mfc
wav\isolated_digits_ti_test_endpt\MAN\NT\3A_endpt.wav	mfctest\3_90.mfc
wav\isolated_digits_ti_test_endpt\MAN\NT\3B_endpt.wav	mfctest\3_91.mfc
wav\isolated_digits_ti_test_endpt\MAN\NT\4A_endpt.wav	mfctest\4_90.mfc
wav\isolated_digits_ti_test_endpt\MAN\NT\4B_endpt.wav	mfctest\4_91.mfc
wav\isolated_digits_ti_test_endpt\MAN\NT\5A_endpt.wav	mfctest\5_90.mfc
wav\isolated_digits_ti_test_endpt\MAN\NT\5B_endpt.wav	mfctest\5_91.mfc
wav\isolated_digits_ti_test_endpt\MAN\NT\6A_endpt.wav	mfctest\6_90.mfc
wav\isolated_digits_ti_test_endpt\MAN\NT\6B_endpt.wav	mfctest\6_91.mfc
wav\isolated_digits_ti_test_endpt\MAN\NT\7A_endpt.wav	mfctest\7_90.mfc
wav\isolated_digits_ti_test_endpt\MAN\NT\7B_endpt.wav	mfctest\7_91.mfc
wav\isolated_digits_ti_test_endpt\MAN\NT\8A_endpt.wav	mfctest\8_90.mfc
wav\isolated_digits_ti_test_endpt\MAN\NT\8B_endpt.wav	mfctest\8_91.mfc
wav\isolated_digits_ti_test_endpt\MAN\NT\9A_endpt.wav	mfctest\9_90.mfc
wav\isolated_digits_ti_test_endpt\MAN\NT\9B_endpt.wav	mfctest\9_91.mfc
wav\isolated_digits_ti_test_endpt\MAN\NT\OA_endpt.wav	mfctest\10_90.mfc
wav\isolated_digits_ti_test_endpt\MAN\NT\OB_endpt.wav	mfctest\10_91.mfc
wav\isolated_digits_ti_test_endpt\MAN\NT\ZA_endpt.wav	mfctest\0_90.mfc
wav\isolated_digits_ti_test_endpt\MAN\NT\ZB_endpt.wav	mfctest\0_91.mfc
wav\isolated_digits_ti_test_endpt\MAN\PC\1A_endpt.wav	mfctest\1_92.mfc
wav\isolated_digits_ti_test_endpt\MAN\PC\1B_endpt.wav	mfctest\1_93.mfc
wav\isolated_digits_ti_test_endpt\MAN\PC\2A_endpt.wav	mfctest\2_92.mfc
wav\isolated_digits_ti_test_endpt\MAN\PC\2B_endpt.wav	mfctest\2_93.mfc
wav\isolated_digits_ti_test_endpt\MAN\PC\3A_endpt.wav	mfctest\3_92.mfc
wav\isolated_digits_ti_test_endpt\MAN\PC\3B_endpt.wav	mfctest\3_93.mfc
wav\isolated_digits_ti_test_endpt\MAN\PC\4A_endpt.wav	mfctest\4_92.mfc
wav\isolated_digits_ti_test_endpt\MAN\PC\4B_endpt.wav	mfctest\4_93.mfc
wav\isolated_digits_ti_test_endpt\MAN\PC\5A_endpt.wav	mfctest\5_92.mfc
wav\isolated_digits_ti_test_endpt\MAN\PC\5B_endpt.wav	mfctest\5_93.mfc
wav\isolated_digits_ti_test_endpt\MAN\PC\6A_endpt.wav	mfctest\6_92.mfc
wav\isolated_digits_ti_test_endpt\MAN\PC\6B_endpt.wav	mfctest\6_93.mfc
wav\isolated_digits_ti_test_endpt\MAN\PC\7A_endpt.wav	mfctest\7_92.mfc
wav\isolated_digits_ti_test_endpt\MAN\PC\7B_endpt.wav	mfctest\7_93.mfc
wav\isolated_digits_ti_test_endpt\MAN\PC\8A_endpt.wav	mfctest\8_92.mfc
wav\isolated_digits_ti_test_endpt\MAN\PC\8B_endpt.wav	mfctest\8_93.mfc
wav\isolated_digits_ti_test_endpt\MAN\PC\9A_endpt.wav	mfctest\9_92.mfc
wav\isolated_digits_ti_test_endpt\MAN\PC\9B_endpt.wav	mfctest\9_93.mfc
wav\isolated_digits_ti_test_endpt\MAN\PC\OA_endpt.wav	mfctest\10_92.mfc
wav\isolated_digits_ti_test_endpt\MAN\PC\OB_endpt.wav	mfctest\10_93.mfc
wav\isolated_digits_ti_test_endpt\MAN\PC\ZA_endpt.wav	mfctest\0_92.mfc
wav\isolated_digits_ti_test_endpt\MAN\PC\ZB_endpt.wav	mfctest\0_93.mfc
wav\isolated_digits_ti_test_endpt\MAN\PG\1A_endpt.wav	mfctest\1_94.mfc
wav\isolated_digits_ti_test_endpt\MAN\PG\1B_endpt.wav	mfctest\1_95.mfc
wav\isolated_digits_ti_test_endpt\MAN\PG\2A_endpt.wav	mfctest\2_94.mfc
wav\isolated_digits_ti_test_endpt\MAN\PG\2B_endpt.wav	mfctest\2_95.mfc
wav\isolated_digits_ti_test_endpt\MAN\PG\3A_endpt.wav	mfctest\3_94.mfc
wav\isolated_digits_ti_test_endpt\MAN\PG\3B_endpt.wav	mfctest\3_95.mfc
wav\isolated_digits_ti_test_endpt\MAN\PG\4A_endpt.wav	mfctest\4_94.mfc
wav\isolated_digits_ti_test_endpt\MAN\PG\4B_endpt.wav	mfctest\4_95.mfc
wav\isolated_digits_ti_test_endpt\MAN\PG\5A_endpt.wav	mfctest\5_94.mfc
wav\isolated_digits_ti_test_endpt\MAN\PG\5B_endpt.wav	mfctest\5_95.mfc
wav\isolated_digits_ti_test_endpt\MAN\PG\6A_endpt.wav	mfctest\6_94.mfc
wav\isolated_digits_ti_test_endpt\MAN\PG\6B_endpt.wav	mfctest\6_95.mfc
wav\isolated_digits_ti_test_endpt\MAN\PG\7A_endpt.wav	mfctest\7_94.mfc
wav\isolated_digits_ti_test_endpt\MAN\PG\7B_endpt.wav	mfctest\7_95.mfc
wav\isolated_digits_ti_test_endpt\MAN\PG\8A_endpt.wav	mfctest\8_94.mfc
wav\isolated_digits_ti_test_endpt\MAN\PG\8B_endpt.wav	mfctest\8_95.mfc
wav\isolated_digits_ti_test_endpt\MAN\PG\9A_endpt.wav	mfctest\9_94.mfc
wav\isolated_digits_ti_test_endpt\MAN\PG\9B_endpt.wav	mfctest\9_95.mfc
wav\isolated_digits_ti_test_endpt\MAN\PG\OA_endpt.wav	mfctest\10_94.mfc
wav\isolated_digits_ti_test_endpt\MAN\PG\OB_endpt.wav	mfctest\10_95.mfc
wav\isolated_digits_ti_test_endpt\MAN\PG\ZA_endpt.wav	mfctest\0_94.mfc
wav\isolated_digits_ti_test_endpt\MAN\PG\ZB_endpt.wav	mfctest\0_95.mfc
wav\isolated_digits_ti_test_endpt\MAN\PH\1A_endpt.wav	mfctest\1_96.mfc
wav\isolated_digits_ti_test_endpt\MAN\PH\1B_endpt.wav	mfctest\1_97.mfc
wav\isolated_digits_ti_test_endpt\MAN\PH\2A_endpt.wav	mfctest\2_96.mfc
wav\isolated_digits_ti_test_endpt\MAN\PH\2B_endpt.wav	mfctest\2_97.mfc
wav\isolated_digits_ti_test_endpt\MAN\PH\3A_endpt.wav	mfctest\3_96.mfc
wav\isolated_digits_ti_test_endpt\MAN\PH\3B_endpt.wav	mfctest\3_97.mfc
wav\isolated_digits_ti_test_endpt\MAN\PH\4A_endpt.wav	mfctest\4_96.mfc
wav\isolated_digits_ti_test_endpt\MAN\PH\4B_endpt.wav	mfctest\4_97.mfc
wav\isolated_digits_ti_test_endpt\MAN\PH\5A_endpt.wav	mfctest\5_96.mfc
wav\isolated_digits_ti_test_endpt\MAN\PH\5B_endpt.wav	mfctest\5_97.mfc
wav\isolated_digits_ti_test_endpt\MAN\PH\6A_endpt.wav	mfctest\6_96.mfc
wav\isolated_digits_ti_test_endpt\MAN\PH\6B_endpt.wav	mfctest\6_97.mfc
wav\isolated_digits_ti_test_endpt\MAN\PH\7A_endpt.wav	mfctest\7_96.mfc
wav\isolated_digits_ti_test_endpt\MAN\PH\7B_endpt.wav	mfctest\7_97.mfc
wav\isolated_digits_ti_test_endpt\MAN\PH\8A_endpt.wav	mfctest\8_96.mfc
wav\isolated_digits_ti_test_endpt\MAN\PH\8B_endpt.wav	mfctest\8_97.mfc
wav\isolated_digits_ti_test_endpt\MAN\PH\9A_endpt.wav	mfctest\9_96.mfc
wav\isolated_digits_ti_test_endpt\MAN\PH\9B_endpt.wav	mfctest\9_97.mfc
wav\isolated_digits_ti_test_endpt\MAN\PH\OA_endpt.wav	mfctest\10_96.mfc
wav\isolated_digits_ti_test_endpt\MAN\PH\OB_endpt.wav	mfctest\10_97.mfc
wav\isolated_digits_ti_test_endpt\MAN\PH\ZA_endpt.wav	mfctest\0_96.mfc
wav\isolated_digits_ti_test_endpt\MAN\PH\ZB_endpt.wav	mfctest\0_97.mfc
wav\isolated_digits_ti_test_endpt\MAN\PR\1A_endpt.wav	mfctest\1_98.mfc
wav\isolated_digits_ti_test_endpt\MAN\PR\1B_endpt.wav	mfctest\1_99.mfc
wav\isolated_digits_ti_test_endpt\MAN\PR\2A_endpt.wav	mfctest\2_98.mfc
wav\isolated_digits_ti_test_endpt\MAN\PR\2B_endpt.wav	mfctest\2_99.mfc
wav\isolated_digits_ti_test_endpt\MAN\PR\3A_endpt.wav	mfctest\3_98.mfc
wav\isolated_digits_ti_test_endpt\MAN\PR\3B_endpt.wav	mfctest\3_99.mfc
wav\isolated_digits_ti_test_endpt\MAN\PR\4A_endpt.wav	mfctest\4_98.mfc
wav\isolated_digits_ti_test_endpt\MAN\PR\4B_endpt.wav	mfctest\4_99.mfc
wav\isolated_digits_ti_test_endpt\MAN\PR\5A_endpt.wav	mfctest\5_98.mfc
wav\isolated_digits_ti_test_endpt\MAN\PR\5B_endpt.wav	mfctest\5_99.mfc
wav\isolated_digits_ti_test_endpt\MAN\PR\6A_endpt.wav	mfctest\6_98.mfc
wav\isolated_digits_ti_test_endpt\MAN\PR\6B_endpt.wav	mfctest\6_99.mfc
wav\isolated_digits_ti_test_endpt\MAN\PR\7A_endpt.wav	mfctest\7_98.mfc
wav\isolated_digits_ti_test_endpt\MAN\PR\7B_endpt.wav	mfctest\7_99.mfc
wav\isolated_digits_ti_test_endpt\MAN\PR\8A_endpt.wav	mfctest\8_98.mfc
wav\isolated_digits_ti_test_endpt\MAN\PR\8B_endpt.wav	mfctest\8_99.mfc
wav\isolated_digits_ti_test_endpt\MAN\PR\9A_endpt.wav	mfctest\9_98.mfc
wav\isolated_digits_ti_test_endpt\MAN\PR\9B_endpt.wav	mfctest\9_99.mfc
wav\isolated_digits_ti_test_endpt\MAN\PR\OA_endpt.wav	mfctest\10_98.mfc
wav\isolated_digits_ti_test_endpt\MAN\PR\OB_endpt.wav	mfctest\10_99.mfc
wav\isolated_digits_ti_test_endpt\MAN\PR\ZA_endpt.wav	mfctest\0_98.mfc
wav\isolated_digits_ti_test_endpt\MAN\PR\ZB_endpt.wav	mfctest\0_99.mfc
wav\isolated_digits_ti_test_endpt\MAN\RK\1A_endpt.wav	mfctest\1_100.mfc
wav\isolated_digits_ti_test_endpt\MAN\RK\1B_endpt.wav	mfctest\1_101.mfc
wav\isolated_digits_ti_test_endpt\MAN\RK\2A_endpt.wav	mfctest\2_100.mfc
wav\isolated_digits_ti_test_endpt\MAN\RK\2B_endpt.wav	mfctest\2_101.mfc
wav\isolated_digits_ti_test_endpt\MAN\RK\3A_endpt.wav	mfctest\3_100.mfc
wav\isolated_digits_ti_test_endpt\MAN\RK\3B_endpt.wav	mfctest\3_101.mfc
wav\isolated_digits_ti_test_endpt\MAN\RK\4A_endpt.wav	mfctest\4_100.mfc
wav\isolated_digits_ti_test_endpt\MAN\RK\4B_endpt.wav	mfctest\4_101.mfc
wav\isolated_digits_ti_test_endpt\MAN\RK\5A_endpt.wav	mfctest\5_100.mfc
wav\isolated_digits_ti_test_endpt\MAN\RK\5B_endpt.wav	mfctest\5_101.mfc
wav\isolated_digits_ti_test_endpt\MAN\RK\6A_endpt.wav	mfctest\6_100.mfc
wav\isolated_digits_ti_test_endpt\MAN\RK\6B_endpt.wav	mfctest\6_101.mfc
wav\isolated_digits_ti_test_endpt\MAN\RK\7A_endpt.wav	mfctest\7_100.mfc
wav\isolated_digits_ti_test_endpt\MAN\RK\7B_endpt.wav	mfctest\7_101.mfc
wav\isolated_digits_ti_test_endpt\MAN\RK\8A_endpt.wav	mfctest\8_100.mfc
wav\isolated_digits_ti_test_endpt\MAN\RK\8B_endpt.wav	mfctest\8_101.mfc
wav\isolated_digits_ti_test_endpt\MAN\RK\9A_endpt.wav	mfctest\9_100.mfc
wav\isolated_digits_ti_test_endpt\MAN\RK\9B_endpt.wav	mfctest\9_101.mfc
wav\isolated_digits_ti_test_endpt\MAN\RK\OA_endpt.wav	mfctest\10_100.mfc
wav\isolated_digits_ti_test_endpt\MAN\RK\OB_endpt.wav	mfctest\10_101.mfc
wav\isolated_digits_ti_test_endpt\MAN\RK\ZA_endpt.wav	mfctest\0_100.mfc
wav\isolated_digits_ti_test_endpt\MAN\RK\ZB_endpt.wav	mfctest\0_101.mfc
wav\isolated_digits_ti_test_endpt\MAN\SA\1A_endpt.wav	mfctest\1_102.mfc
wav\isolated_digits_ti_test_endpt\MAN\SA\1B_endpt.wav	mfctest\1_103.mfc
wav\isolated_digits_ti_test_endpt\MAN\SA\2A_endpt.wav	mfctest\2_102.mfc
wav\isolated_digits_ti_test_endpt\MAN\SA\2B_endpt.wav	mfctest\2_103.mfc
wav\isolated_digits_ti_test_endpt\MAN\SA\3A_endpt.wav	mfctest\3_102.mfc
wav\isolated_digits_ti_test_endpt\MAN\SA\3B_endpt.wav	mfctest\3_103.mfc
wav\isolated_digits_ti_test_endpt\MAN\SA\4A_endpt.wav	mfctest\4_102.mfc
wav\isolated_digits_ti_test_endpt\MAN\SA\4B_endpt.wav	mfctest\4_103.mfc
wav\isolated_digits_ti_test_endpt\MAN\SA\5A_endpt.wav	mfctest\5_102.mfc
wav\isolated_digits_ti_test_endpt\MAN\SA\5B_endpt.wav	mfctest\5_103.mfc
wav\isolated_digits_ti_test_endpt\MAN\SA\6A_endpt.wav	mfctest\6_102.mfc
wav\isolated_digits_ti_test_endpt\MAN\SA\6B_endpt.wav	mfctest\6_103.mfc
wav\isolated_digits_ti_test_endpt\MAN\SA\7A_endpt.wav	mfctest\7_102.mfc
wav\isolated_digits_ti_test_endpt\MAN\SA\7B_endpt.wav	mfctest\7_103.mfc
wav\isolated_digits_ti_test_endpt\MAN\SA\8A_endpt.wav	mfctest\8_102.mfc
wav\isolated_digits_ti_test_endpt\MAN\SA\8B_endpt.wav	mfctest\8_103.mfc
wav\isolated_digits_ti_test_endpt\MAN\SA\9A_endpt.wav	mfctest\9_102.mfc
wav\isolated_digits_ti_test_endpt\MAN\SA\9B_endpt.wav	mfctest\9_103.mfc
wav\isolated_digits_ti_test_endpt\MAN\SA\OA_endpt.wav	mfctest\10_102.mfc
wav\isolated_digits_ti_test_endpt\MAN\SA\OB_endpt.wav	mfctest\10_103.mfc
wav\isolated_digits_ti_test_endpt\MAN\SA\ZA_endpt.wav	mfctest\0_102.mfc
wav\isolated_digits_ti_test_endpt\MAN\SA\ZB_endpt.wav	mfctest\0_103.mfc
wav\isolated_digits_ti_test_endpt\MAN\SL\1A_endpt.wav	mfctest\1_104.mfc
wav\isolated_digits_ti_test_endpt\MAN\SL\1B_endpt.wav	mfctest\1_105.mfc
wav\isolated_digits_ti_test_endpt\MAN\SL\2A_endpt.wav	mfctest\2_104.mfc
wav\isolated_digits_ti_test_endpt\MAN\SL\2B_endpt.wav	mfctest\2_105.mfc
wav\isolated_digits_ti_test_endpt\MAN\SL\3A_endpt.wav	mfctest\3_104.mfc
wav\isolated_digits_ti_test_endpt\MAN\SL\3B_endpt.wav	mfctest\3_105.mfc
wav\isolated_digits_ti_test_endpt\MAN\SL\4A_endpt.wav	mfctest\4_104.mfc
wav\isolated_digits_ti_test_endpt\MAN\SL\4B_endpt.wav	mfctest\4_105.mfc
wav\isolated_digits_ti_test_endpt\MAN\SL\5A_endpt.wav	mfctest\5_104.mfc
wav\isolated_digits_ti_test_endpt\MAN\SL\5B_endpt.wav	mfctest\5_105.mfc
wav\isolated_digits_ti_test_endpt\MAN\SL\6A_endpt.wav	mfctest\6_104.mfc
wav\isolated_digits_ti_test_endpt\MAN\SL\6B_endpt.wav	mfctest\6_105.mfc
wav\isolated_digits_ti_test_endpt\MAN\SL\7A_endpt.wav	mfctest\7_104.mfc
wav\isolated_digits_ti_test_endpt\MAN\SL\7B_endpt.wav	mfctest\7_105.mfc
wav\isolated_digits_ti_test_endpt\MAN\SL\8A_endpt.wav	mfctest\8_104.mfc
wav\isolated_digits_ti_test_endpt\MAN\SL\8B_endpt.wav	mfctest\8_105.mfc
wav\isolated_digits_ti_test_endpt\MAN\SL\9A_endpt.wav	mfctest\9_104.mfc
wav\isolated_digits_ti_test_endpt\MAN\SL\9B_endpt.wav	mfctest\9_105.mfc
wav\isolated_digits_ti_test_endpt\MAN\SL\OA_endpt.wav	mfctest\10_104.mfc
wav\isolated_digits_ti_test_endpt\MAN\SL\OB_endpt.wav	mfctest\10_105.mfc
wav\isolated_digits_ti_test_endpt\MAN\SL\ZA_endpt.wav	mfctest\0_104.mfc
wav\isolated_digits_ti_test_endpt\MAN\SL\ZB_endpt.wav	mfctest\0_105.mfc
wav\isolated_digits_ti_test_endpt\MAN\SR\1A_endpt.wav	mfctest\1_106.mfc
wav\isolated_digits_ti_test_endpt\MAN\SR\1B_endpt.wav	mfctest\1_107.mfc
wav\isolated_digits_ti_test_endpt\MAN\SR\2A_endpt.wav	mfctest\2_106.mfc
wav\isolated_digits_ti_test_endpt\MAN\SR\2B_endpt.wav	mfctest\2_107.mfc
wav\isolated_digits_ti_test_endpt\MAN\SR\3A_endpt.wav	mfctest\3_106.mfc
wav\isolated_digits_ti_test_endpt\MAN\SR\3B_endpt.wav	mfctest\3_107.mfc
wav\isolated_digits_ti_test_endpt\MAN\SR\4A_endpt.wav	mfctest\4_106.mfc
wav\isolated_digits_ti_test_endpt\MAN\SR\4B_endpt.wav	mfctest\4_107.mfc
wav\isolated_digits_ti_test_endpt\MAN\SR\5A_endpt.wav	mfctest\5_106.mfc
wav\isolated_digits_ti_test_endpt\MAN\SR\5B_endpt.wav	mfctest\5_107.mfc
wav\isolated_digits_ti_test_endpt\MAN\SR\6A_endpt.wav	mfctest\6_106.mfc
wav\isolated_digits_ti_test_endpt\MAN\SR\6B_endpt.wav	mfctest\6_107.mfc
wav\isolated_digits_ti_test_endpt\MAN\SR\7A_endpt.wav	mfctest\7_106.mfc
wav\isolated_digits_ti_test_endpt\MAN\SR\7B_endpt.wav	mfctest\7_107.mfc
wav\isolated_digits_ti_test_endpt\MAN\SR\8A_endpt.wav	mfctest\8_106.mfc
wav\isolated_digits_ti_test_endpt\MAN\SR\8B_endpt.wav	mfctest\8_107.mfc
wav\isolated_digits_ti_test_endpt\MAN\SR\9A_endpt.wav	mfctest\9_106.mfc
wav\isolated_digits_ti_test_endpt\MAN\SR\9B_endpt.wav	mfctest\9_107.mfc
wav\isolated_digits_ti_test_endpt\MAN\SR\OA_endpt.wav	mfctest\10_106.mfc
wav\isolated_digits_ti_test_endpt\MAN\SR\OB_endpt.wav	mfctest\10_107.mfc
wav\isolated_digits_ti_test_endpt\MAN\SR\ZA_endpt.wav	mfctest\0_106.mfc
wav\isolated_digits_ti_test_endpt\MAN\SR\ZB_endpt.wav	mfctest\0_107.mfc
wav\isolated_digits_ti_test_endpt\MAN\SW\1A_endpt.wav	mfctest\1_108.mfc
wav\isolated_digits_ti_test_endpt\MAN\SW\1B_endpt.wav	mfctest\1_109.mfc
wav\isolated_digits_ti_test_endpt\MAN\SW\2A_endpt.wav	mfctest\2_108.mfc
wav\isolated_digits_ti_test_endpt\MAN\SW\2B_endpt.wav	mfctest\2_109.mfc
wav\isolated_digits_ti_test_endpt\MAN\SW\3A_endpt.wav	mfctest\3_108.mfc
wav\isolated_digits_ti_test_endpt\MAN\SW\3B_endpt.wav	mfctest\3_109.mfc
wav\isolated_digits_ti_test_endpt\MAN\SW\4A_endpt.wav	mfctest\4_108.mfc
wav\isolated_digits_ti_test_endpt\MAN\SW\4B_endpt.wav	mfctest\4_109.mfc
wav\isolated_digits_ti_test_endpt\MAN\SW\5A_endpt.wav	mfctest\5_108.mfc
wav\isolated_digits_ti_test_endpt\MAN\SW\5B_endpt.wav	mfctest\5_109.mfc
wav\isolated_digits_ti_test_endpt\MAN\SW\6A_endpt.wav	mfctest\6_108.mfc
wav\isolated_digits_ti_test_endpt\MAN\SW\6B_endpt.wav	mfctest\6_109.mfc
wav\isolated_digits_ti_test_endpt\MAN\SW\7A_endpt.wav	mfctest\7_108.mfc
wav\isolated_digits_ti_test_endpt\MAN\SW\7B_endpt.wav	mfctest\7_109.mfc
wav\isolated_digits_ti_test_endpt\MAN\SW\8A_endpt.wav	mfctest\8_108.mfc
wav\isolated_digits_ti_test_endpt\MAN\SW\8B_endpt.wav	mfctest\8_109.mfc
wav\isolated_digits_ti_test_endpt\MAN\SW\9A_endpt.wav	mfctest\9_108.mfc
wav\isolated_digits_ti_test_endpt\MAN\SW\9B_endpt.wav	mfctest\9_109.mfc
wav\isolated_digits_ti_test_endpt\MAN\SW\OA_endpt.wav	mfctest\10_108.mfc
wav\isolated_digits_ti_test_endpt\MAN\SW\OB_endpt.wav	mfctest\10_109.mfc
wav\isolated_digits_ti_test_endpt\MAN\SW\ZA_endpt.wav	mfctest\0_108.mfc
wav\isolated_digits_ti_test_endpt\MAN\SW\ZB_endpt.wav	mfctest\0_109.mfc
wav\isolated_digits_ti_test_endpt\MAN\TC\1A_endpt.wav	mfctest\1_110.mfc
wav\isolated_digits_ti_test_endpt\MAN\TC\1B_endpt.wav	mfctest\1_111.mfc
wav\isolated_digits_ti_test_endpt\MAN\TC\2A_endpt.wav	mfctest\2_110.mfc
wav\isolated_digits_ti_test_endpt\MAN\TC\2B_endpt.wav	mfctest\2_111.mfc
wav\isolated_digits_ti_test_endpt\MAN\TC\3A_endpt.wav	mfctest\3_110.mfc
wav\isolated_digits_ti_test_endpt\MAN\TC\3B_endpt.wav	mfctest\3_111.mfc
wav\isolated_digits_ti_test_endpt\MAN\TC\4A_endpt.wav	mfctest\4_110.mfc
wav\isolated_digits_ti_test_endpt\MAN\TC\4B_endpt.wav	mfctest\4_111.mfc
wav\isolated_digits_ti_test_endpt\MAN\TC\5A_endpt.wav	mfctest\5_110.mfc
wav\isolated_digits_ti_test_endpt\MAN\TC\5B_endpt.wav	mfctest\5_111.mfc
wav\isolated_digits_ti_test_endpt\MAN\TC\6A_endpt.wav	mfctest\6_110.mfc
wav\isolated_digits_ti_test_endpt\MAN\TC\6B_endpt.wav	mfctest\6_111.mfc
wav\isolated_digits_ti_test_endpt\MAN\TC\7A_endpt.wav	mfctest\7_110.mfc
wav\isolated_digits_ti_test_endpt\MAN\TC\7B_endpt.wav	mfctest\7_111.mfc
wav\isolated_digits_ti_test_endpt\MAN\TC\8A_endpt.wav	mfctest\8_110.mfc
wav\isolated_digits_ti_test_endpt\MAN\TC\8B_endpt.wav	mfctest\8_111.mfc
wav\isolated_digits_ti_test_endpt\MAN\TC\9A_endpt.wav	mfctest\9_110.mfc
wav\isolated_digits_ti_test_endpt\MAN\TC\9B_endpt.wav	mfctest\9_111.mfc
wav\isolated_digits_ti_test_endpt\MAN\TC\OA_endpt.wav	mfctest\10_110.mfc
wav\isolated_digits_ti_test_endpt\MAN\TC\OB_endpt.wav	mfctest\10_111.mfc
wav\isolated_digits_ti_test_endpt\MAN\TC\ZA_endpt.wav	mfctest\0_110.mfc
wav\isolated_digits_ti_test_endpt\MAN\TC\ZB_endpt.wav	mfctest\0_111.mfc
wav\isolated_digits_ti_test_endpt\WOMAN\AK\1A_endpt.wav	mfctest\1_112.mfc
wav\isolated_digits_ti_test_endpt\WOMAN\AK\1B_endpt.wav	mfctest\1_113.mfc
wav\isolated_digits_ti_test_endpt\WOMAN\AK\2A_endpt.wav	mfctest\2_112.mfc
wav\isolated_digits_ti_test_endpt\WOMAN\AK\2B_endpt.wav	mfctest\2_113.mfc
wav\isolated_digits_ti_test_endpt\WOMAN\AK\3A_endpt.wav	mfctest\3_112.mfc
wav\isolated_digits_ti_test_endpt\WOMAN\AK\3B_endpt.wav	mfctest\3_113.mfc
wav\isolated_digits_ti_test_endpt\WOMAN\AK\4A_endpt.wav	mfctest\4_112.mfc
wav\isolated_digits_ti_test_endpt\WOMAN\AK\4B_endpt.wav	mfctest\4_113.mfc
wav\isolated_digits_ti_test_endpt\WOMAN\AK\5A_endpt.wav	mfctest\5_112.mfc
wav\isolated_digits_ti_test_endpt\WOMAN\AK\5B_endpt.wav	mfctest\5_113.mfc
wav\isolated_digits_ti_test_endpt\WOMAN\AK\6A_endpt.wav	mfctest\6_112.mfc
wav\isolated_digits_ti_test_endpt\WOMAN\AK\6B_endpt.wav	mfctest\6_113.mfc
wav\isolated_digits_ti_test_endpt\WOMAN\AK\7A_endpt.wav	mfctest\7_112.mfc
wav\isolated_digits_ti_test_endpt\WOMAN\AK\7B_endpt.wav	mfctest\7_113.mfc
wav\isolated_digits_ti_test_endpt\WOMAN\AK\8A_endpt.wav	mfctest\8_112.mfc
wav\isolated_digits_ti_test_endpt\WOMAN\AK\8B_endpt.wav	mfctest\8_113.mfc
wav\isolated_digits_ti_test_endpt\WOMAN\AK\9A_endpt.wav	mfctest\9_112.mfc
wav\isolated_digits_ti_test_endpt\WOMAN\AK\9B_endpt.wav	mfctest\9_113.mfc
wav\isolated_digits_ti_test_endpt\WOMAN\AK\OA_endpt.wav	mfctest\10_112.mfc
wav\isolated_digits_ti_test_endpt\WOMAN\AK\OB_endpt.wav	mfctest\10_113.mfc
wav\isolated_digits_ti_test_endpt\WOMAN\AK\ZA_endpt.wav	mfctest\0_112.mfc
wav\isolated_digits_ti_test_endpt\WOMAN\AK\ZB_endpt.wav	mfctest\0_113.mfc
wav\isolated_digits_ti_test_endpt\WOMAN\AP\1A_endpt.wav	mfctest\1_114.mfc
wav\isolated_digits_ti_test_endpt\WOMAN\AP\1B_endpt.wav	mfctest\1_115.mfc
wav\isolated_digits_ti_test_endpt\WOMAN\AP\2A_endpt.wav	mfctest\2_114.mfc
wav\isolated_digits_ti_test_endpt\WOMAN\AP\2B_endpt.wav	mfctest\2_115.mfc
wav\isolated_digits_ti_test_endpt\WOMAN\AP\3A_endpt.wav	mfctest\3_114.mfc
wav\isolated_digits_ti_test_endpt\WOMAN\AP\3B_endpt.wav	mfctest\3_115.mfc
wav\isolated_digits_ti_test_endpt\WOMAN\AP\4A_endpt.wav	mfctest\4_114.mfc
wav\isolated_digits_ti_test_endpt\WOMAN\AP\4B_endpt.wav	mfctest\4_115.mfc
wav\isolated_digits_ti_test_endpt\WOMAN\AP\5A_endpt.wav	mfctest\5_114.mfc
wav\isolated_digits_ti_test_endpt\WOMAN\AP\5B_endpt.wav	mfctest\5_115.mfc
wav\isolated_digits_ti_test_endpt\WOMAN\AP\6A_endpt.wav	mfctest\6_114.mfc
wav\isolated_digits_ti_test_endpt\WOMAN\AP\6B_endpt.wav	mfctest\6_115.mfc
wav\isolated_digits_ti_test_endpt\WOMAN\AP\7A_endpt.wav	mfctest\7_114.mfc
wav\isolated_digits_ti_test_endpt\WOMAN\AP\7B_endpt.wav	mfctest\7_115.mfc
wav\isolated_digits_ti_test_endpt\WOMAN\AP\8A_endpt.wav	mfctest\8_114.mfc
wav\isolated_digits_ti_test_endpt\WOMAN\AP\8B_endpt.wav	mfctest\8_115.mfc
wav\isolated_digits_ti_test_endpt\WOMAN\AP\9A_endpt.wav	mfctest\9_114.mfc
wav\isolated_digits_ti_test_endpt\WOMAN\AP\9B_endpt.wav	mfctest\9_115.mfc
wav\isolated_digits_ti_test_endpt\WOMAN\AP\OA_endpt.wav	mfctest\10_114.mfc
wav\isolated_digits_ti_test_endpt\WOMAN\AP\OB_endpt.wav	mfctest\10_115.mfc
wav\isolated_digits_ti_test_endpt\WOMAN\AP\ZA_endpt.wav	mfctest\0_114.mfc
wav\isolated_digits_ti_test_endpt\WOMAN\AP\ZB_endpt.wav	mfctest\0_115.mfc
wav\isolated_digits_ti_test_endpt\WOMAN\BA\1A_endpt.wav	mfctest\1_116.mfc
wav\isolated_digits_ti_test_endpt\WOMAN\BA\1B_endpt.wav	mfctest\1_117.mfc
wav\isolated_digits_ti_test_endpt\WOMAN\BA\2A_endpt.wav	mfctest\2_116.mfc
wav\isolated_digits_ti_test_endpt\WOMAN\BA\2B_endpt.wav	mfctest\2_117.mfc
wav\isolated_digits_ti_test_endpt\WOMAN\BA\3A_endpt.wav	mfctest\3_116.mfc
wav\isolated_digits_ti_test_endpt\WOMAN\BA\3B_endpt.wav	mfctest\3_117.mfc
wav\isolated_digits_ti_test_endpt\WOMAN\BA\4A_endpt.wav	mfctest\4_116.mfc
wav\isolated_digits_ti_test_endpt\WOMAN\BA\4B_endpt.wav	mfctest\4_117.mfc
wav\isolated_digits_ti_test_endpt\WOMAN\BA\5A_endpt.wav	mfctest\5_116.mfc
wav\isolated_digits_ti_test_endpt\WOMAN\BA\5B_endpt.wav	mfctest\5_117.mfc
wav\isolated_digits_ti_test_endpt\WOMAN\BA\6A_endpt.wav	mfctest\6_116.mfc
wav\isolated_digits_ti_test_endpt\WOMAN\BA\6B_endpt.wav	mfctest\6_117.mfc
wav\isolated_digits_ti_test_endpt\WOMAN\BA\7A_endpt.wav	mfctest\7_116.mfc
wav\isolated_digits_ti_test_endpt\WOMAN\BA\7B_endpt.wav	mfctest\7_117.mfc
wav\isolated_digits_ti_test_endpt\WOMAN\BA\8A_endpt.wav	mfctest\8_116.mfc
wav\isolated_digits_ti_test_endpt\WOMAN\BA\8B_endpt.wav	mfctest\8_117.mfc
wav\isolated_digits_ti_test_endpt\WOMAN\BA\9A_endpt.wav	mfctest\9_116.mfc
wav\isolated_digits_ti_test_endpt\WOMAN\BA\9B_endpt.wav	mfctest\9_117.mfc
wav\isolated_digits_ti_test_endpt\WOMAN\BA\OA_endpt.wav	mfctest\10_116.mfc
wav\isolated_digits_ti_test_endpt\WOMAN\BA\OB_endpt.wav	mfctest\10_117.mfc
wav\isolated_digits_ti_test_endpt\WOMAN\BA\ZA_endpt.wav	mfctest\0_116.mfc
wav\isolated_digits_ti_test_endpt\WOMAN\BA\ZB_endpt.wav	mfctest\0_117.mfc
wav\isolated_digits_ti_test_endpt\WOMAN\BF\1A_endpt.wav	mfctest\1_118.mfc
wav\isolated_digits_ti_test_endpt\WOMAN\BF\1B_endpt.wav	mfctest\1_119.mfc
wav\isolated_digits_ti_test_endpt\WOMAN\BF\2A_endpt.wav	mfctest\2_118.mfc
wav\isolated_digits_ti_test_endpt\WOMAN\BF\2B_endpt.wav	mfctest\2_119.mfc
wav\isolated_digits_ti_test_endpt\WOMAN\BF\3A_endpt.wav	mfctest\3_118.mfc
wav\isolated_digits_ti_test_endpt\WOMAN\BF\3B_endpt.wav	mfctest\3_119.mfc
wav\isolated_digits_ti_test_endpt\WOMAN\BF\4A_endpt.wav	mfctest\4_118.mfc
wav\isolated_digits_ti_test_endpt\WOMAN\BF\4B_endpt.wav	mfctest\4_119.mfc
wav\isolated_digits_ti_test_endpt\WOMAN\BF\5A_endpt.wav	mfctest\5_118.mfc
wav\isolated_digits_ti_test_endpt\WOMAN\BF\5B_endpt.wav	mfctest\5_119.mfc
wav\isolated_digits_ti_test_endpt\WOMAN\BF\6A_endpt.wav	mfctest\6_118.mfc
wav\isolated_digits_ti_test_endpt\WOMAN\BF\6B_endpt.wav	mfctest\6_119.mfc
wav\isolated_digits_ti_test_endpt\WOMAN\BF\7A_endpt.wav	mfctest\7_118.mfc
wav\isolated_digits_ti_test_endpt\WOMAN\BF\7B_endpt.wav	mfctest\7_119.mfc
wav\isolated_digits_ti_test_endpt\WOMAN\BF\8A_endpt.wav	mfctest\8_118.mfc
wav\isolated_digits_ti_test_endpt\WOMAN\BF\8B_endpt.wav	mfctest\8_119.mfc
wav\isolated_digits_ti_test_endpt\WOMAN\BF\9A_endpt.wav	mfctest\9_118.mfc
wav\isolated_digits_ti_test_endpt\WOMAN\BF\9B_endpt.wav	mfctest\9_119.mfc
wav\isolated_digits_ti_test_endpt\WOMAN\BF\OA_endpt.wav	mfctest\10_118.mfc
wav\isolated_digits_ti_test_endpt\WOMAN\BF\OB_endpt.wav	mfctest\10_119.mfc
wav\isolated_digits_ti_test_endpt\WOMAN\BF\ZA_endpt.wav	mfctest\0_118.mfc
wav\isolated_digits_ti_test_endpt\WOMAN\BF\ZB_endpt.wav	mfctest\0_119.mfc
wav\isolated_digits_ti_test_endpt\WOMAN\BJ\1A_endpt.wav	mfctest\1_120.mfc
wav\isolated_digits_ti_test_endpt\WOMAN\BJ\1B_endpt.wav	mfctest\1_121.mfc
wav\isolated_digits_ti_test_endpt\WOMAN\BJ\2A_endpt.wav	mfctest\2_120.mfc
wav\isolated_digits_ti_test_endpt\WOMAN\BJ\2B_endpt.wav	mfctest\2_121.mfc
wav\isolated_digits_ti_test_endpt\WOMAN\BJ\3A_endpt.wav	mfctest\3_120.mfc
wav\isolated_digits_ti_test_endpt\WOMAN\BJ\3B_endpt.wav	mfctest\3_121.mfc
wav\isolated_digits_ti_test_endpt\WOMAN\BJ\4A_endpt.wav	mfctest\4_120.mfc
wav\isolated_digits_ti_test_endpt\WOMAN\BJ\4B_endpt.wav	mfctest\4_121.mfc
wav\isolated_digits_ti_test_endpt\WOMAN\BJ\5A_endpt.wav	mfctest\5_120.mfc
wav\isolated_digits_ti_test_endpt\WOMAN\BJ\5B_endpt.wav	mfctest\5_121.mfc
wav\isolated_digits_ti_test_endpt\WOMAN\BJ\6A_endpt.wav	mfctest\6_120.mfc
wav\isolated_digits_ti_test_endpt\WOMAN\BJ\6B_endpt.wav	mfctest\6_121.mfc
wav\isolated_digits_ti_test_endpt\WOMAN\BJ\7A_endpt.wav	mfctest\7_120.mfc
wav\isolated_digits_ti_test_endpt\WOMAN\BJ\7B_endpt.wav	mfctest\7_121.mfc
wav\isolated_digits_ti_test_endpt\WOMAN\BJ\8A_endpt.wav	mfctest\8_120.mfc
wav\isolated_digits_ti_test_endpt\WOMAN\BJ\8B_endpt.wav	mfctest\8_121.mfc
wav\isolated_digits_ti_test_endpt\WOMAN\BJ\9A_endpt.wav	mfctest\9_120.mfc
wav\isolated_digits_ti_test_endpt\WOMAN\BJ\9B_endpt.wav	mfctest\9_121.mfc
wav\isolated_digits_ti_test_endpt\WOMAN\BJ\OA_endpt.wav	mfctest\10_120.mfc
wav\isolated_digits_ti_test_endpt\WOMAN\BJ\OB_endpt.wav	mfctest\10_121.mfc
wav\isolated_digits_ti_test_endpt\WOMAN\BJ\ZA_endpt.wav	mfctest\0_120.mfc
wav\isolated_digits_ti_test_endpt\WOMAN\BJ\ZB_endpt.wav	mfctest\0_121.mfc
wav\isolated_digits_ti_test_endpt\WOMAN\BL\1A_endpt.wav	mfctest\1_122.mfc
wav\isolated_digits_ti_test_endpt\WOMAN\BL\1B_endpt.wav	mfctest\1_123.mfc
wav\isolated_digits_ti_test_endpt\WOMAN\BL\2A_endpt.wav	mfctest\2_122.mfc
wav\isolated_digits_ti_test_endpt\WOMAN\BL\2B_endpt.wav	mfctest\2_123.mfc
wav\isolated_digits_ti_test_endpt\WOMAN\BL\3A_endpt.wav	mfctest\3_122.mfc
wav\isolated_digits_ti_test_endpt\WOMAN\BL\3B_endpt.wav	mfctest\3_123.mfc
wav\isolated_digits_ti_test_endpt\WOMAN\BL\4A_endpt.wav	mfctest\4_122.mfc
wav\isolated_digits_ti_test_endpt\WOMAN\BL\4B_endpt.wav	mfctest\4_123.mfc
wav\isolated_digits_ti_test_endpt\WOMAN\BL\5A_endpt.wav	mfctest\5_122.mfc
wav\isolated_digits_ti_test_endpt\WOMAN\BL\5B_endpt.wav	mfctest\5_123.mfc
wav\isolated_digits_ti_test_endpt\WOMAN\BL\6A_endpt.wav	mfctest\6_122.mfc
wav\isolated_digits_ti_test_endpt\WOMAN\BL\6B_endpt.wav	mfctest\6_123.mfc
wav\isolated_digits_ti_test_endpt\WOMAN\BL\7A_endpt.wav	mfctest\7_122.mfc
wav\isolated_digits_ti_test_endpt\WOMAN\BL\7B_endpt.wav	mfctest\7_123.mfc
wav\isolated_digits_ti_test_endpt\WOMAN\BL\8A_endpt.wav	mfctest\8_122.mfc
wav\isolated_digits_ti_test_endpt\WOMAN\BL\8B_endpt.wav	mfctest\8_123.mfc
wav\isolated_digits_ti_test_endpt\WOMAN\BL\9A_endpt.wav	mfctest\9_122.mfc
wav\isolated_digits_ti_test_endpt\WOMAN\BL\9B_endpt.wav	mfctest\9_123.mfc
wav\isolated_digits_ti_test_endpt\WOMAN\BL\OA_endpt.wav	mfctest\10_122.mfc
wav\isolated_digits_ti_test_endpt\WOMAN\BL\OB_endpt.wav	mfctest\10_123.mfc
wav\isolated_digits_ti_test_endpt\WOMAN\BL\ZA_endpt.wav	mfctest\0_122.mfc
wav\isolated_digits_ti_test_endpt\WOMAN\BL\ZB_endpt.wav	mfctest\0_123.mfc
wav\isolated_digits_ti_test_endpt\WOMAN\BS\1A_endpt.wav	mfctest\1_124.mfc
wav\isolated_digits_ti_test_endpt\WOMAN\BS\1B_endpt.wav	mfctest\1_125.mfc
wav\isolated_digits_ti_test_endpt\WOMAN\BS\2A_endpt.wav	mfctest\2_124.mfc
wav\isolated_digits_ti_test_endpt\WOMAN\BS\2B_endpt.wav	mfctest\2_125.mfc
wav\isolated_digits_ti_test_endpt\WOMAN\BS\3A_endpt.wav	mfctest\3_124.mfc
wav\isolated_digits_ti_test_endpt\WOMAN\BS\3B_endpt.wav	mfctest\3_125.mfc
wav\isolated_digits_ti_test_endpt\WOMAN\BS\4A_endpt.wav	mfctest\4_124.mfc
wav\isolated_digits_ti_test_endpt\WOMAN\BS\4B_endpt.wav	mfctest\4_125.mfc
wav\isolated_digits_ti_test_endpt\WOMAN\BS\5A_endpt.wav	mfctest\5_124.mfc
wav\isolated_digits_ti_test_endpt\WOMAN\BS\5B_endpt.wav	mfctest\5_125.mfc
wav\isolated_digits_ti_test_endpt\WOMAN\BS\6A_endpt.wav	mfctest\6_124.mfc
wav\isolated_digits_ti_test_endpt\WOMAN\BS\6B_endpt.wav	mfctest\6_125.mfc
wav\isolated_digits_ti_test_endpt\WOMAN\BS\7A_endpt.wav	mfctest\7_124.mfc
wav\isolated_digits_ti_test_endpt\WOMAN\BS\7B_endpt.wav	mfctest\7_125.mfc
wav\isolated_digits_ti_test_endpt\WOMAN\BS\8A_endpt.wav	mfctest\8_124.mfc
wav\isolated_digits_ti_test_endpt\WOMAN\BS\8B_endpt.wav	mfctest\8_125.mfc
wav\isolated_digits_ti_test_endpt\WOMAN\BS\9A_endpt.wav	mfctest\9_124.mfc
wav\isolated_digits_ti_test_endpt\WOMAN\BS\9B_endpt.wav	mfctest\9_125.mfc
wav\isolated_digits_ti_test_endpt\WOMAN\BS\OA_endpt.wav	mfctest\10_124.mfc
wav\isolated_digits_ti_test_endpt\WOMAN\BS\OB_endpt.wav	mfctest\10_125.mfc
wav\isolated_digits_ti_test_endpt\WOMAN\BS\ZA_endpt.wav	mfctest\0_124.mfc
wav\isolated_digits_ti_test_endpt\WOMAN\BS\ZB_endpt.wav	mfctest\0_125.mfc
wav\isolated_digits_ti_test_endpt\WOMAN\BW\1A_endpt.wav	mfctest\1_126.mfc
wav\isolated_digits_ti_test_endpt\WOMAN\BW\1B_endpt.wav	mfctest\1_127.mfc
wav\isolated_digits_ti_test_endpt\WOMAN\BW\2A_endpt.wav	mfctest\2_126.mfc
wav\isolated_digits_ti_test_endpt\WOMAN\BW\2B_endpt.wav	mfctest\2_127.mfc
wav\isolated_digits_ti_test_endpt\WOMAN\BW\3A_endpt.wav	mfctest\3_126.mfc
wav\isolated_digits_ti_test_endpt\WOMAN\BW\3B_endpt.wav	mfctest\3_127.mfc
wav\isolated_digits_ti_test_endpt\WOMAN\BW\4A_endpt.wav	mfctest\4_126.mfc
wav\isolated_digits_ti_test_endpt\WOMAN\BW\4B_endpt.wav	mfctest\4_127.mfc
wav\isolated_digits_ti_test_endpt\WOMAN\BW\5A_endpt.wav	mfctest\5_126.mfc
wav\isolated_digits_ti_test_endpt\WOMAN\BW\5B_endpt.wav	mfctest\5_127.mfc
wav\isolated_digits_ti_test_endpt\WOMAN\BW\6A_endpt.wav	mfctest\6_126.mfc
wav\isolated_digits_ti_test_endpt\WOMAN\BW\6B_endpt.wav	mfctest\6_127.mfc
wav\isolated_digits_ti_test_endpt\WOMAN\BW\7A_endpt.wav	mfctest\7_126.mfc
wav\isolated_digits_ti_test_endpt\WOMAN\BW\7B_endpt.wav	mfctest\7_127.mfc
wav\isolated_digits_ti_test_endpt\WOMAN\BW\8A_endpt.wav	mfctest\8_126.mfc
wav\isolated_digits_ti_test_endpt\WOMAN\BW\8B_endpt.wav	mfctest\8_127.mfc
wav\isolated_digits_ti_test_endpt\WOMAN\BW\9A_endpt.wav	mfctest\9_126.mfc
wav\isolated_digits_ti_test_endpt\WOMAN\BW\9B_endpt.wav	mfctest\9_127.mfc
wav\isolated_digits_ti_test_endpt\WOMAN\BW\OA_endpt.wav	mfctest\10_126.mfc
wav\isolated_digits_ti_test_endpt\WOMAN\BW\OB_endpt.wav	mfctest\10_127.mfc
wav\isolated_digits_ti_test_endpt\WOMAN\BW\ZA_endpt.wav	mfctest\0_126.mfc
wav\isolated_digits_ti_test_endpt\WOMAN\BW\ZB_endpt.wav	mfctest\0_127.mfc
wav\isolated_digits_ti_test_endpt\WOMAN\CD\1A_endpt.wav	mfctest\1_128.mfc
wav\isolated_digits_ti_test_endpt\WOMAN\CD\1B_endpt.wav	mfctest\1_129.mfc
wav\isolated_digits_ti_test_endpt\WOMAN\CD\2A_endpt.wav	mfctest\2_128.mfc
wav\isolated_digits_ti_test_endpt\WOMAN\CD\2B_endpt.wav	mfctest\2_129.mfc
wav\isolated_digits_ti_test_endpt\WOMAN\CD\3A_endpt.wav	mfctest\3_128.mfc
wav\isolated_digits_ti_test_endpt\WOMAN\CD\3B_endpt.wav	mfctest\3_129.mfc
wav\isolated_digits_ti_test_endpt\WOMAN\CD\4A_endpt.wav	mfctest\4_128.mfc
wav\isolated_digits_ti_test_endpt\WOMAN\CD\4B_endpt.wav	mfctest\4_129.mfc
wav\isolated_digits_ti_test_endpt\WOMAN\CD\5A_endpt.wav	mfctest\5_128.mfc
wav\isolated_digits_ti_test_endpt\WOMAN\CD\5B_endpt.wav	mfctest\5_129.mfc
wav\isolated_digits_ti_test_endpt\WOMAN\CD\6A_endpt.wav	mfctest\6_128.mfc
wav\isolated_digits_ti_test_endpt\WOMAN\CD\6B_endpt.wav	mfctest\6_129.mfc
wav\isolated_digits_ti_test_endpt\WOMAN\CD\7A_endpt.wav	mfctest\7_128.mfc
wav\isolated_digits_ti_test_endpt\WOMAN\CD\7B_endpt.wav	mfctest\7_129.mfc
wav\isolated_digits_ti_test_endpt\WOMAN\CD\8A_endpt.wav	mfctest\8_128.mfc
wav\isolated_digits_ti_test_endpt\WOMAN\CD\8B_endpt.wav	mfctest\8_129.mfc
wav\isolated_digits_ti_test_endpt\WOMAN\CD\9A_endpt.wav	mfctest\9_128.mfc
wav\isolated_digits_ti_test_endpt\WOMAN\CD\9B_endpt.wav	mfctest\9_129.mfc
wav\isolated_digits_ti_test_endpt\WOMAN\CD\OA_endpt.wav	mfctest\10_128.mfc
wav\isolated_digits_ti_test_endpt\WOMAN\CD\OB_endpt.wav	mfctest\10_129.mfc
wav\isolated_digits_ti_test_endpt\WOMAN\CD\ZA_endpt.wav	mfctest\0_128.mfc
wav\isolated_digits_ti_test_endpt\WOMAN\CD\ZB_endpt.wav	mfctest\0_129.mfc
wav\isolated_digits_ti_test_endpt\WOMAN\CJ\1A_endpt.wav	mfctest\1_130.mfc
wav\isolated_digits_ti_test_endpt\WOMAN\CJ\1B_endpt.wav	mfctest\1_131.mfc
wav\isolated_digits_ti_test_endpt\WOMAN\CJ\2A_endpt.wav	mfctest\2_130.mfc
wav\isolated_digits_ti_test_endpt\WOMAN\CJ\2B_endpt.wav	mfctest\2_131.mfc
wav\isolated_digits_ti_test_endpt\WOMAN\CJ\3A_endpt.wav	mfctest\3_130.mfc
wav\isolated_digits_ti_test_endpt\WOMAN\CJ\3B_endpt.wav	mfctest\3_131.mfc
wav\isolated_digits_ti_test_endpt\WOMAN\CJ\4A_endpt.wav	mfctest\4_130.mfc
wav\isolated_digits_ti_test_endpt\WOMAN\CJ\4B_endpt.wav	mfctest\4_131.mfc
wav\isolated_digits_ti_test_endpt\WOMAN\CJ\5A_endpt.wav	mfctest\5_130.mfc
wav\isolated_digits_ti_test_endpt\WOMAN\CJ\5B_endpt.wav	mfctest\5_131.mfc
wav\isolated_digits_ti_test_endpt\WOMAN\CJ\6A_endpt.wav	mfctest\6_130.mfc
wav\isolated_digits_ti_test_endpt\WOMAN\CJ\6B_endpt.wav	mfctest\6_131.mfc
wav\isolated_digits_ti_test_endpt\WOMAN\CJ\7A_endpt.wav	mfctest\7_130.mfc
wav\isolated_digits_ti_test_endpt\WOMAN\CJ\7B_endpt.wav	mfctest\7_131.mfc
wav\isolated_digits_ti_test_endpt\WOMAN\CJ\8A_endpt.wav	mfctest\8_130.mfc
wav\isolated_digits_ti_test_endpt\WOMAN\CJ\8B_endpt.wav	mfctest\8_131.mfc
wav\isolated_digits_ti_test_endpt\WOMAN\CJ\9A_endpt.wav	mfctest\9_130.mfc
wav\isolated_digits_ti_test_endpt\WOMAN\CJ\9B_endpt.wav	mfctest\9_131.mfc
wav\isolated_digits_ti_test_endpt\WOMAN\CJ\OA_endpt.wav	mfctest\10_130.mfc
wav\isolated_digits_ti_test_endpt\WOMAN\CJ\OB_endpt.wav	mfctest\10_131.mfc
wav\isolated_digits_ti_test_endpt\WOMAN\CJ\ZA_endpt.wav	mfctest\0_130.mfc
wav\isolated_digits_ti_test_endpt\WOMAN\CJ\ZB_endpt.wav	mfctest\0_131.mfc
wav\isolated_digits_ti_test_endpt\WOMAN\CS\1A_endpt.wav	mfctest\1_132.mfc
wav\isolated_digits_ti_test_endpt\WOMAN\CS\1B_endpt.wav	mfctest\1_133.mfc
wav\isolated_digits_ti_test_endpt\WOMAN\CS\2A_endpt.wav	mfctest\2_132.mfc
wav\isolated_digits_ti_test_endpt\WOMAN\CS\2B_endpt.wav	mfctest\2_133.mfc
wav\isolated_digits_ti_test_endpt\WOMAN\CS\3A_endpt.wav	mfctest\3_132.mfc
wav\isolated_digits_ti_test_endpt\WOMAN\CS\3B_endpt.wav	mfctest\3_133.mfc
wav\isolated_digits_ti_test_endpt\WOMAN\CS\4A_endpt.wav	mfctest\4_132.mfc
wav\isolated_digits_ti_test_endpt\WOMAN\CS\4B_endpt.wav	mfctest\4_133.mfc
wav\isolated_digits_ti_test_endpt\WOMAN\CS\5A_endpt.wav	mfctest\5_132.mfc
wav\isolated_digits_ti_test_endpt\WOMAN\CS\5B_endpt.wav	mfctest\5_133.mfc
wav\isolated_digits_ti_test_endpt\WOMAN\CS\6A_endpt.wav	mfctest\6_132.mfc
wav\isolated_digits_ti_test_endpt\WOMAN\CS\6B_endpt.wav	mfctest\6_133.mfc
wav\isolated_digits_ti_test_endpt\WOMAN\CS\7A_endpt.wav	mfctest\7_132.mfc
wav\isolated_digits_ti_test_endpt\WOMAN\CS\7B_endpt.wav	mfctest\7_133.mfc
wav\isolated_digits_ti_test_endpt\WOMAN\CS\8A_endpt.wav	mfctest\8_132.mfc
wav\isolated_digits_ti_test_endpt\WOMAN\CS\8B_endpt.wav	mfctest\8_133.mfc
wav\isolated_digits_ti_test_endpt\WOMAN\CS\9A_endpt.wav	mfctest\9_132.mfc
wav\isolated_digits_ti_test_endpt\WOMAN\CS\9B_endpt.wav	mfctest\9_133.mfc
wav\isolated_digits_ti_test_endpt\WOMAN\CS\OA_endpt.wav	mfctest\10_132.mfc
wav\isolated_digits_ti_test_endpt\WOMAN\CS\OB_endpt.wav	mfctest\10_133.mfc
wav\isolated_digits_ti_test_endpt\WOMAN\CS\ZA_endpt.wav	mfctest\0_132.mfc
wav\isolated_digits_ti_test_endpt\WOMAN\CS\ZB_endpt.wav	mfctest\0_133.mfc
wav\isolated_digits_ti_test_endpt\WOMAN\CT\1A_endpt.wav	mfctest\1_134.mfc
wav\isolated_digits_ti_test_endpt\WOMAN\CT\1B_endpt.wav	mfctest\1_135.mfc
wav\isolated_digits_ti_test_endpt\WOMAN\CT\2A_endpt.wav	mfctest\2_134.mfc
wav\isolated_digits_ti_test_endpt\WOMAN\CT\2B_endpt.wav	mfctest\2_135.mfc
wav\isolated_digits_ti_test_endpt\WOMAN\CT\3A_endpt.wav	mfctest\3_134.mfc
wav\isolated_digits_ti_test_endpt\WOMAN\CT\3B_endpt.wav	mfctest\3_135.mfc
wav\isolated_digits_ti_test_endpt\WOMAN\CT\4A_endpt.wav	mfctest\4_134.mfc
wav\isolated_digits_ti_test_endpt\WOMAN\CT\4B_endpt.wav	mfctest\4_135.mfc
wav\isolated_digits_ti_test_endpt\WOMAN\CT\5A_endpt.wav	mfctest\5_134.mfc
wav\isolated_digits_ti_test_endpt\WOMAN\CT\5B_endpt.wav	mfctest\5_135.mfc
wav\isolated_digits_ti_test_endpt\WOMAN\CT\6A_endpt.wav	mfctest\6_134.mfc
wav\isolated_digits_ti_test_endpt\WOMAN\CT\6B_endpt.wav	mfctest\6_135.mfc
wav\isolated_digits_ti_test_endpt\WOMAN\CT\7A_endpt.wav	mfctest\7_134.mfc
wav\isolated_digits_ti_test_endpt\WOMAN\CT\7B_endpt.wav	mfctest\7_135.mfc
wav\isolated_digits_ti_test_endpt\WOMAN\CT\8A_endpt.wav	mfctest\8_134.mfc
wav\isolated_digits_ti_test_endpt\WOMAN\CT\8B_endpt.wav	mfctest\8_135.mfc
wav\isolated_digits_ti_test_endpt\WOMAN\CT\9A_endpt.wav	mfctest\9_134.mfc
wav\isolated_digits_ti_test_endpt\WOMAN\CT\9B_endpt.wav	mfctest\9_135.mfc
wav\isolated_digits_ti_test_endpt\WOMAN\CT\OA_endpt.wav	mfctest\10_134.mfc
wav\isolated_digits_ti_test_endpt\WOMAN\CT\OB_endpt.wav	mfctest\10_135.mfc
wav\isolated_digits_ti_test_endpt\WOMAN\CT\ZA_endpt.wav	mfctest\0_134.mfc
wav\isolated_digits_ti_test_endpt\WOMAN\CT\ZB_endpt.wav	mfctest\0_135.mfc
wav\isolated_digits_ti_test_endpt\WOMAN\DP\1A_endpt.wav	mfctest\1_136.mfc
wav\isolated_digits_ti_test_endpt\WOMAN\DP\1B_endpt.wav	mfctest\1_137.mfc
wav\isolated_digits_ti_test_endpt\WOMAN\DP\2A_endpt.wav	mfctest\2_136.mfc
wav\isolated_digits_ti_test_endpt\WOMAN\DP\2B_endpt.wav	mfctest\2_137.mfc
wav\isolated_digits_ti_test_endpt\WOMAN\DP\3A_endpt.wav	mfctest\3_136.mfc
wav\isolated_digits_ti_test_endpt\WOMAN\DP\3B_endpt.wav	mfctest\3_137.mfc
wav\isolated_digits_ti_test_endpt\WOMAN\DP\4A_endpt.wav	mfctest\4_136.mfc
wav\isolated_digits_ti_test_endpt\WOMAN\DP\4B_endpt.wav	mfctest\4_137.mfc
wav\isolated_digits_ti_test_endpt\WOMAN\DP\5A_endpt.wav	mfctest\5_136.mfc
wav\isolated_digits_ti_test_endpt\WOMAN\DP\5B_endpt.wav	mfctest\5_137.mfc
wav\isolated_digits_ti_test_endpt\WOMAN\DP\6A_endpt.wav	mfctest\6_136.mfc
wav\isolated_digits_ti_test_endpt\WOMAN\DP\6B_endpt.wav	mfctest\6_137.mfc
wav\isolated_digits_ti_test_endpt\WOMAN\DP\7A_endpt.wav	mfctest\7_136.mfc
wav\isolated_digits_ti_test_endpt\WOMAN\DP\7B_endpt.wav	mfctest\7_137.mfc
wav\isolated_digits_ti_test_endpt\WOMAN\DP\8A_endpt.wav	mfctest\8_136.mfc
wav\isolated_digits_ti_test_endpt\WOMAN\DP\8B_endpt.wav	mfctest\8_137.mfc
wav\isolated_digits_ti_test_endpt\WOMAN\DP\9A_endpt.wav	mfctest\9_136.mfc
wav\isolated_digits_ti_test_endpt\WOMAN\DP\9B_endpt.wav	mfctest\9_137.mfc
wav\isolated_digits_ti_test_endpt\WOMAN\DP\OA_endpt.wav	mfctest\10_136.mfc
wav\isolated_digits_ti_test_endpt\WOMAN\DP\OB_endpt.wav	mfctest\10_137.mfc
wav\isolated_digits_ti_test_endpt\WOMAN\DP\ZA_endpt.wav	mfctest\0_136.mfc
wav\isolated_digits_ti_test_endpt\WOMAN\DP\ZB_endpt.wav	mfctest\0_137.mfc
wav\isolated_digits_ti_test_endpt\WOMAN\DR\1A_endpt.wav	mfctest\1_138.mfc
wav\isolated_digits_ti_test_endpt\WOMAN\DR\1B_endpt.wav	mfctest\1_139.mfc
wav\isolated_digits_ti_test_endpt\WOMAN\DR\2A_endpt.wav	mfctest\2_138.mfc
wav\isolated_digits_ti_test_endpt\WOMAN\DR\2B_endpt.wav	mfctest\2_139.mfc
wav\isolated_digits_ti_test_endpt\WOMAN\DR\3A_endpt.wav	mfctest\3_138.mfc
wav\isolated_digits_ti_test_endpt\WOMAN\DR\3B_endpt.wav	mfctest\3_139.mfc
wav\isolated_digits_ti_test_endpt\WOMAN\DR\4A_endpt.wav	mfctest\4_138.mfc
wav\isolated_digits_ti_test_endpt\WOMAN\DR\4B_endpt.wav	mfctest\4_139.mfc
wav\isolated_digits_ti_test_endpt\WOMAN\DR\5A_endpt.wav	mfctest\5_138.mfc
wav\isolated_digits_ti_test_endpt\WOMAN\DR\5B_endpt.wav	mfctest\5_139.mfc
wav\isolated_digits_ti_test_endpt\WOMAN\DR\6A_endpt.wav	mfctest\6_138.mfc
wav\isolated_digits_ti_test_endpt\WOMAN\DR\6B_endpt.wav	mfctest\6_139.mfc
wav\isolated_digits_ti_test_endpt\WOMAN\DR\7A_endpt.wav	mfctest\7_138.mfc
wav\isolated_digits_ti_test_endpt\WOMAN\DR\7B_endpt.wav	mfctest\7_139.mfc
wav\isolated_digits_ti_test_endpt\WOMAN\DR\8A_endpt.wav	mfctest\8_138.mfc
wav\isolated_digits_ti_test_endpt\WOMAN\DR\8B_endpt.wav	mfctest\8_139.mfc
wav\isolated_digits_ti_test_endpt\WOMAN\DR\9A_endpt.wav	mfctest\9_138.mfc
wav\isolated_digits_ti_test_endpt\WOMAN\DR\9B_endpt.wav	mfctest\9_139.mfc
wav\isolated_digits_ti_test_endpt\WOMAN\DR\OA_endpt.wav	mfctest\10_138.mfc
wav\isolated_digits_ti_test_endpt\WOMAN\DR\OB_endpt.wav	mfctest\10_139.mfc
wav\isolated_digits_ti_test_endpt\WOMAN\DR\ZA_endpt.wav	mfctest\0_138.mfc
wav\isolated_digits_ti_test_endpt\WOMAN\DR\ZB_endpt.wav	mfctest\0_139.mfc
wav\isolated_digits_ti_test_endpt\WOMAN\DW\1A_endpt.wav	mfctest\1_140.mfc
wav\isolated_digits_ti_test_endpt\WOMAN\DW\1B_endpt.wav	mfctest\1_141.mfc
wav\isolated_digits_ti_test_endpt\WOMAN\DW\2A_endpt.wav	mfctest\2_140.mfc
wav\isolated_digits_ti_test_endpt\WOMAN\DW\2B_endpt.wav	mfctest\2_141.mfc
wav\isolated_digits_ti_test_endpt\WOMAN\DW\3A_endpt.wav	mfctest\3_140.mfc
wav\isolated_digits_ti_test_endpt\WOMAN\DW\3B_endpt.wav	mfctest\3_141.mfc
wav\isolated_digits_ti_test_endpt\WOMAN\DW\4A_endpt.wav	mfctest\4_140.mfc
wav\isolated_digits_ti_test_endpt\WOMAN\DW\4B_endpt.wav	mfctest\4_141.mfc
wav\isolated_digits_ti_test_endpt\WOMAN\DW\5A_endpt.wav	mfctest\5_140.mfc
wav\isolated_digits_ti_test_endpt\WOMAN\DW\5B_endpt.wav	mfctest\5_141.mfc
wav\isolated_digits_ti_test_endpt\WOMAN\DW\6A_endpt.wav	mfctest\6_140.mfc
wav\isolated_digits_ti_test_endpt\WOMAN\DW\6B_endpt.wav	mfctest\6_141.mfc
wav\isolated_digits_ti_test_endpt\WOMAN\DW\7A_endpt.wav	mfctest\7_140.mfc
wav\isolated_digits_ti_test_endpt\WOMAN\DW\7B_endpt.wav	mfctest\7_141.mfc
wav\isolated_digits_ti_test_endpt\WOMAN\DW\8A_endpt.wav	mfctest\8_140.mfc
wav\isolated_digits_ti_test_endpt\WOMAN\DW\8B_endpt.wav	mfctest\8_141.mfc
wav\isolated_digits_ti_test_endpt\WOMAN\DW\9A_endpt.wav	mfctest\9_140.mfc
wav\isolated_digits_ti_test_endpt\WOMAN\DW\9B_endpt.wav	mfctest\9_141.mfc
wav\isolated_digits_ti_test_endpt\WOMAN\DW\OA_endpt.wav	mfctest\10_140.mfc
wav\isolated_digits_ti_test_endpt\WOMAN\DW\OB_endpt.wav	mfctest\10_141.mfc
wav\isolated_digits_ti_test_endpt\WOMAN\DW\ZA_endpt.wav	mfctest\0_140.mfc
wav\isolated_digits_ti_test_endpt\WOMAN\DW\ZB_endpt.wav	mfctest\0_141.mfc
wav\isolated_digits_ti_test_endpt\WOMAN\EJ\1A_endpt.wav	mfctest\1_142.mfc
wav\isolated_digits_ti_test_endpt\WOMAN\EJ\1B_endpt.wav	mfctest\1_143.mfc
wav\isolated_digits_ti_test_endpt\WOMAN\EJ\2A_endpt.wav	mfctest\2_142.mfc
wav\isolated_digits_ti_test_endpt\WOMAN\EJ\2B_endpt.wav	mfctest\2_143.mfc
wav\isolated_digits_ti_test_endpt\WOMAN\EJ\3A_endpt.wav	mfctest\3_142.mfc
wav\isolated_digits_ti_test_endpt\WOMAN\EJ\3B_endpt.wav	mfctest\3_143.mfc
wav\isolated_digits_ti_test_endpt\WOMAN\EJ\4A_endpt.wav	mfctest\4_142.mfc
wav\isolated_digits_ti_test_endpt\WOMAN\EJ\4B_endpt.wav	mfctest\4_143.mfc
wav\isolated_digits_ti_test_endpt\WOMAN\EJ\5A_endpt.wav	mfctest\5_142.mfc
wav\isolated_digits_ti_test_endpt\WOMAN\EJ\5B_endpt.wav	mfctest\5_143.mfc
wav\isolated_digits_ti_test_endpt\WOMAN\EJ\6A_endpt.wav	mfctest\6_142.mfc
wav\isolated_digits_ti_test_endpt\WOMAN\EJ\6B_endpt.wav	mfctest\6_143.mfc
wav\isolated_digits_ti_test_endpt\WOMAN\EJ\7A_endpt.wav	mfctest\7_142.mfc
wav\isolated_digits_ti_test_endpt\WOMAN\EJ\7B_endpt.wav	mfctest\7_143.mfc
wav\isolated_digits_ti_test_endpt\WOMAN\EJ\8A_endpt.wav	mfctest\8_142.mfc
wav\isolated_digits_ti_test_endpt\WOMAN\EJ\8B_endpt.wav	mfctest\8_143.mfc
wav\isolated_digits_ti_test_endpt\WOMAN\EJ\9A_endpt.wav	mfctest\9_142.mfc
wav\isolated_digits_ti_test_endpt\WOMAN\EJ\9B_endpt.wav	mfctest\9_143.mfc
wav\isolated_digits_ti_test_endpt\WOMAN\EJ\OA_endpt.wav	mfctest\10_142.mfc
wav\isolated_digits_ti_test_endpt\WOMAN\EJ\OB_endpt.wav	mfctest\10_143.mfc
wav\isolated_digits_ti_test_endpt\WOMAN\EJ\ZA_endpt.wav	mfctest\0_142.mfc
wav\isolated_digits_ti_test_endpt\WOMAN\EJ\ZB_endpt.wav	mfctest\0_143.mfc
wav\isolated_digits_ti_test_endpt\WOMAN\EM\1A_endpt.wav	mfctest\1_144.mfc
wav\isolated_digits_ti_test_endpt\WOMAN\EM\1B_endpt.wav	mfctest\1_145.mfc
wav\isolated_digits_ti_test_endpt\WOMAN\EM\2A_endpt.wav	mfctest\2_144.mfc
wav\isolated_digits_ti_test_endpt\WOMAN\EM\2B_endpt.wav	mfctest\2_145.mfc
wav\isolated_digits_ti_test_endpt\WOMAN\EM\3A_endpt.wav	mfctest\3_144.mfc
wav\isolated_digits_ti_test_endpt\WOMAN\EM\3B_endpt.wav	mfctest\3_145.mfc
wav\isolated_digits_ti_test_endpt\WOMAN\EM\4A_endpt.wav	mfctest\4_144.mfc
wav\isolated_digits_ti_test_endpt\WOMAN\EM\4B_endpt.wav	mfctest\4_145.mfc
wav\isolated_digits_ti_test_endpt\WOMAN\EM\5A_endpt.wav	mfctest\5_144.mfc
wav\isolated_digits_ti_test_endpt\WOMAN\EM\5B_endpt.wav	mfctest\5_145.mfc
wav\isolated_digits_ti_test_endpt\WOMAN\EM\6A_endpt.wav	mfctest\6_144.mfc
wav\isolated_digits_ti_test_endpt\WOMAN\EM\6B_endpt.wav	mfctest\6_145.mfc
wav\isolated_digits_ti_test_endpt\WOMAN\EM\7A_endpt.wav	mfctest\7_144.mfc
wav\isolated_digits_ti_test_endpt\WOMAN\EM\7B_endpt.wav	mfctest\7_145.mfc
wav\isolated_digits_ti_test_endpt\WOMAN\EM\8A_endpt.wav	mfctest\8_144.mfc
wav\isolated_digits_ti_test_endpt\WOMAN\EM\8B_endpt.wav	mfctest\8_145.mfc
wav\isolated_digits_ti_test_endpt\WOMAN\EM\9A_endpt.wav	mfctest\9_144.mfc
wav\isolated_digits_ti_test_endpt\WOMAN\EM\9B_endpt.wav	mfctest\9_145.mfc
wav\isolated_digits_ti_test_endpt\WOMAN\EM\OA_endpt.wav	mfctest\10_144.mfc
wav\isolated_digits_ti_test_endpt\WOMAN\EM\OB_endpt.wav	mfctest\10_145.mfc
wav\isolated_digits_ti_test_endpt\WOMAN\EM\ZA_endpt.wav	mfctest\0_144.mfc
wav\isolated_digits_ti_test_endpt\WOMAN\EM\ZB_endpt.wav	mfctest\0_145.mfc
wav\isolated_digits_ti_test_endpt\WOMAN\EP\1A_endpt.wav	mfctest\1_146.mfc
wav\isolated_digits_ti_test_endpt\WOMAN\EP\1B_endpt.wav	mfctest\1_147.mfc
wav\isolated_digits_ti_test_endpt\WOMAN\EP\2A_endpt.wav	mfctest\2_146.mfc
wav\isolated_digits_ti_test_endpt\WOMAN\EP\2B_endpt.wav	mfctest\2_147.mfc
wav\isolated_digits_ti_test_endpt\WOMAN\EP\3A_endpt.wav	mfctest\3_146.mfc
wav\isolated_digits_ti_test_endpt\WOMAN\EP\3B_endpt.wav	mfctest\3_147.mfc
wav\isolated_digits_ti_test_endpt\WOMAN\EP\4A_endpt.wav	mfctest\4_146.mfc
wav\isolated_digits_ti_test_endpt\WOMAN\EP\4B_endpt.wav	mfctest\4_147.mfc
wav\isolated_digits_ti_test_endpt\WOMAN\EP\5A_endpt.wav	mfctest\5_146.mfc
wav\isolated_digits_ti_test_endpt\WOMAN\EP\5B_endpt.wav	mfctest\5_147.mfc
wav\isolated_digits_ti_test_endpt\WOMAN\EP\6A_endpt.wav	mfctest\6_146.mfc
wav\isolated_digits_ti_test_endpt\WOMAN\EP\6B_endpt.wav	mfctest\6_147.mfc
wav\isolated_digits_ti_test_endpt\WOMAN\EP\7A_endpt.wav	mfctest\7_146.mfc
wav\isolated_digits_ti_test_endpt\WOMAN\EP\7B_endpt.wav	mfctest\7_147.mfc
wav\isolated_digits_ti_test_endpt\WOMAN\EP\8A_endpt.wav	mfctest\8_146.mfc
wav\isolated_digits_ti_test_endpt\WOMAN\EP\8B_endpt.wav	mfctest\8_147.mfc
wav\isolated_digits_ti_test_endpt\WOMAN\EP\9A_endpt.wav	mfctest\9_146.mfc
wav\isolated_digits_ti_test_endpt\WOMAN\EP\9B_endpt.wav	mfctest\9_147.mfc
wav\isolated_digits_ti_test_endpt\WOMAN\EP\OA_endpt.wav	mfctest\10_146.mfc
wav\isolated_digits_ti_test_endpt\WOMAN\EP\OB_endpt.wav	mfctest\10_147.mfc
wav\isolated_digits_ti_test_endpt\WOMAN\EP\ZA_endpt.wav	mfctest\0_146.mfc
wav\isolated_digits_ti_test_endpt\WOMAN\EP\ZB_endpt.wav	mfctest\0_147.mfc
wav\isolated_digits_ti_test_endpt\WOMAN\ER\1A_endpt.wav	mfctest\1_148.mfc
wav\isolated_digits_ti_test_endpt\WOMAN\ER\1B_endpt.wav	mfctest\1_149.mfc
wav\isolated_digits_ti_test_endpt\WOMAN\ER\2A_endpt.wav	mfctest\2_148.mfc
wav\isolated_digits_ti_test_endpt\WOMAN\ER\2B_endpt.wav	mfctest\2_149.mfc
wav\isolated_digits_ti_test_endpt\WOMAN\ER\3A_endpt.wav	mfctest\3_148.mfc
wav\isolated_digits_ti_test_endpt\WOMAN\ER\3B_endpt.wav	mfctest\3_149.mfc
wav\isolated_digits_ti_test_endpt\WOMAN\ER\4A_endpt.wav	mfctest\4_148.mfc
wav\isolated_digits_ti_test_endpt\WOMAN\ER\4B_endpt.wav	mfctest\4_149.mfc
wav\isolated_digits_ti_test_endpt\WOMAN\ER\5A_endpt.wav	mfctest\5_148.mfc
wav\isolated_digits_ti_test_endpt\WOMAN\ER\5B_endpt.wav	mfctest\5_149.mfc
wav\isolated_digits_ti_test_endpt\WOMAN\ER\6A_endpt.wav	mfctest\6_148.mfc
wav\isolated_digits_ti_test_endpt\WOMAN\ER\6B_endpt.wav	mfctest\6_149.mfc
wav\isolated_digits_ti_test_endpt\WOMAN\ER\7A_endpt.wav	mfctest\7_148.mfc
wav\isolated_digits_ti_test_endpt\WOMAN\ER\7B_endpt.wav	mfctest\7_149.mfc
wav\isolated_digits_ti_test_endpt\WOMAN\ER\8A_endpt.wav	mfctest\8_148.mfc
wav\isolated_digits_ti_test_endpt\WOMAN\ER\8B_endpt.wav	mfctest\8_149.mfc
wav\isolated_digits_ti_test_endpt\WOMAN\ER\9A_endpt.wav	mfctest\9_148.mfc
wav\isolated_digits_ti_test_endpt\WOMAN\ER\9B_endpt.wav	mfctest\9_149.mfc
wav\isolated_digits_ti_test_endpt\WOMAN\ER\OA_endpt.wav	mfctest\10_148.mfc
wav\isolated_digits_ti_test_endpt\WOMAN\ER\OB_endpt.wav	mfctest\10_149.mfc
wav\isolated_digits_ti_test_endpt\WOMAN\ER\ZA_endpt.wav	mfctest\0_148.mfc
wav\isolated_digits_ti_test_endpt\WOMAN\ER\ZB_endpt.wav	mfctest\0_149.mfc
wav\isolated_digits_ti_test_endpt\WOMAN\EW\1A_endpt.wav	mfctest\1_150.mfc
wav\isolated_digits_ti_test_endpt\WOMAN\EW\1B_endpt.wav	mfctest\1_151.mfc
wav\isolated_digits_ti_test_endpt\WOMAN\EW\2A_endpt.wav	mfctest\2_150.mfc
wav\isolated_digits_ti_test_endpt\WOMAN\EW\2B_endpt.wav	mfctest\2_151.mfc
wav\isolated_digits_ti_test_endpt\WOMAN\EW\3A_endpt.wav	mfctest\3_150.mfc
wav\isolated_digits_ti_test_endpt\WOMAN\EW\3B_endpt.wav	mfctest\3_151.mfc
wav\isolated_digits_ti_test_endpt\WOMAN\EW\4A_endpt.wav	mfctest\4_150.mfc
wav\isolated_digits_ti_test_endpt\WOMAN\EW\4B_endpt.wav	mfctest\4_151.mfc
wav\isolated_digits_ti_test_endpt\WOMAN\EW\5A_endpt.wav	mfctest\5_150.mfc
wav\isolated_digits_ti_test_endpt\WOMAN\EW\5B_endpt.wav	mfctest\5_151.mfc
wav\isolated_digits_ti_test_endpt\WOMAN\EW\6A_endpt.wav	mfctest\6_150.mfc
wav\isolated_digits_ti_test_endpt\WOMAN\EW\6B_endpt.wav	mfctest\6_151.mfc
wav\isolated_digits_ti_test_endpt\WOMAN\EW\7A_endpt.wav	mfctest\7_150.mfc
wav\isolated_digits_ti_test_endpt\WOMAN\EW\7B_endpt.wav	mfctest\7_151.mfc
wav\isolated_digits_ti_test_endpt\WOMAN\EW\8A_endpt.wav	mfctest\8_150.mfc
wav\isolated_digits_ti_test_endpt\WOMAN\EW\8B_endpt.wav	mfctest\8_151.mfc
wav\isolated_digits_ti_test_endpt\WOMAN\EW\9A_endpt.wav	mfctest\9_150.mfc
wav\isolated_digits_ti_test_endpt\WOMAN\EW\9B_endpt.wav	mfctest\9_151.mfc
wav\isolated_digits_ti_test_endpt\WOMAN\EW\OA_endpt.wav	mfctest\10_150.mfc
wav\isolated_digits_ti_test_endpt\WOMAN\EW\OB_endpt.wav	mfctest\10_151.mfc
wav\isolated_digits_ti_test_endpt\WOMAN\EW\ZA_endpt.wav	mfctest\0_150.mfc
wav\isolated_digits_ti_test_endpt\WOMAN\EW\ZB_endpt.wav	mfctest\0_151.mfc
wav\isolated_digits_ti_test_endpt\WOMAN\FN\1A_endpt.wav	mfctest\1_152.mfc
wav\isolated_digits_ti_test_endpt\WOMAN\FN\1B_endpt.wav	mfctest\1_153.mfc
wav\isolated_digits_ti_test_endpt\WOMAN\FN\2A_endpt.wav	mfctest\2_152.mfc
wav\isolated_digits_ti_test_endpt\WOMAN\FN\2B_endpt.wav	mfctest\2_153.mfc
wav\isolated_digits_ti_test_endpt\WOMAN\FN\3A_endpt.wav	mfctest\3_152.mfc
wav\isolated_digits_ti_test_endpt\WOMAN\FN\3B_endpt.wav	mfctest\3_153.mfc
wav\isolated_digits_ti_test_endpt\WOMAN\FN\4A_endpt.wav	mfctest\4_152.mfc
wav\isolated_digits_ti_test_endpt\WOMAN\FN\4B_endpt.wav	mfctest\4_153.mfc
wav\isolated_digits_ti_test_endpt\WOMAN\FN\5A_endpt.wav	mfctest\5_152.mfc
wav\isolated_digits_ti_test_endpt\WOMAN\FN\5B_endpt.wav	mfctest\5_153.mfc
wav\isolated_digits_ti_test_endpt\WOMAN\FN\6A_endpt.wav	mfctest\6_152.mfc
wav\isolated_digits_ti_test_endpt\WOMAN\FN\6B_endpt.wav	mfctest\6_153.mfc
wav\isolated_digits_ti_test_endpt\WOMAN\FN\7A_endpt.wav	mfctest\7_152.mfc
wav\isolated_digits_ti_test_endpt\WOMAN\FN\7B_endpt.wav	mfctest\7_153.mfc
wav\isolated_digits_ti_test_endpt\WOMAN\FN\8A_endpt.wav	mfctest\8_152.mfc
wav\isolated_digits_ti_test_endpt\WOMAN\FN\8B_endpt.wav	mfctest\8_153.mfc
wav\isolated_digits_ti_test_endpt\WOMAN\FN\9A_endpt.wav	mfctest\9_152.mfc
wav\isolated_digits_ti_test_endpt\WOMAN\FN\9B_endpt.wav	mfctest\9_153.mfc
wav\isolated_digits_ti_test_endpt\WOMAN\FN\OA_endpt.wav	mfctest\10_152.mfc
wav\isolated_digits_ti_test_endpt\WOMAN\FN\OB_endpt.wav	mfctest\10_153.mfc
wav\isolated_digits_ti_test_endpt\WOMAN\FN\ZA_endpt.wav	mfctest\0_152.mfc
wav\isolated_digits_ti_test_endpt\WOMAN\FN\ZB_endpt.wav	mfctest\0_153.mfc
wav\isolated_digits_ti_test_endpt\WOMAN\GB\1A_endpt.wav	mfctest\1_154.mfc
wav\isolated_digits_ti_test_endpt\WOMAN\GB\1B_endpt.wav	mfctest\1_155.mfc
wav\isolated_digits_ti_test_endpt\WOMAN\GB\2A_endpt.wav	mfctest\2_154.mfc
wav\isolated_digits_ti_test_endpt\WOMAN\GB\2B_endpt.wav	mfctest\2_155.mfc
wav\isolated_digits_ti_test_endpt\WOMAN\GB\3A_endpt.wav	mfctest\3_154.mfc
wav\isolated_digits_ti_test_endpt\WOMAN\GB\3B_endpt.wav	mfctest\3_155.mfc
wav\isolated_digits_ti_test_endpt\WOMAN\GB\4A_endpt.wav	mfctest\4_154.mfc
wav\isolated_digits_ti_test_endpt\WOMAN\GB\4B_endpt.wav	mfctest\4_155.mfc
wav\isolated_digits_ti_test_endpt\WOMAN\GB\5A_endpt.wav	mfctest\5_154.mfc
wav\isolated_digits_ti_test_endpt\WOMAN\GB\5B_endpt.wav	mfctest\5_155.mfc
wav\isolated_digits_ti_test_endpt\WOMAN\GB\6A_endpt.wav	mfctest\6_154.mfc
wav\isolated_digits_ti_test_endpt\WOMAN\GB\6B_endpt.wav	mfctest\6_155.mfc
wav\isolated_digits_ti_test_endpt\WOMAN\GB\7A_endpt.wav	mfctest\7_154.mfc
wav\isolated_digits_ti_test_endpt\WOMAN\GB\7B_endpt.wav	mfctest\7_155.mfc
wav\isolated_digits_ti_test_endpt\WOMAN\GB\8A_endpt.wav	mfctest\8_154.mfc
wav\isolated_digits_ti_test_endpt\WOMAN\GB\8B_endpt.wav	mfctest\8_155.mfc
wav\isolated_digits_ti_test_endpt\WOMAN\GB\9A_endpt.wav	mfctest\9_154.mfc
wav\isolated_digits_ti_test_endpt\WOMAN\GB\9B_endpt.wav	mfctest\9_155.mfc
wav\isolated_digits_ti_test_endpt\WOMAN\GB\OA_endpt.wav	mfctest\10_154.mfc
wav\isolated_digits_ti_test_endpt\WOMAN\GB\OB_endpt.wav	mfctest\10_155.mfc
wav\isolated_digits_ti_test_endpt\WOMAN\GB\ZA_endpt.wav	mfctest\0_154.mfc
wav\isolated_digits_ti_test_endpt\WOMAN\GB\ZB_endpt.wav	mfctest\0_155.mfc
wav\isolated_digits_ti_test_endpt\WOMAN\GC\1A_endpt.wav	mfctest\1_156.mfc
wav\isolated_digits_ti_test_endpt\WOMAN\GC\1B_endpt.wav	mfctest\1_157.mfc
wav\isolated_digits_ti_test_endpt\WOMAN\GC\2A_endpt.wav	mfctest\2_156.mfc
wav\isolated_digits_ti_test_endpt\WOMAN\GC\2B_endpt.wav	mfctest\2_157.mfc
wav\isolated_digits_ti_test_endpt\WOMAN\GC\3A_endpt.wav	mfctest\3_156.mfc
wav\isolated_digits_ti_test_endpt\WOMAN\GC\3B_endpt.wav	mfctest\3_157.mfc
wav\isolated_digits_ti_test_endpt\WOMAN\GC\4A_endpt.wav	mfctest\4_156.mfc
wav\isolated_digits_ti_test_endpt\WOMAN\GC\4B_endpt.wav	mfctest\4_157.mfc
wav\isolated_digits_ti_test_endpt\WOMAN\GC\5A_endpt.wav	mfctest\5_156.mfc
wav\isolated_digits_ti_test_endpt\WOMAN\GC\5B_endpt.wav	mfctest\5_157.mfc
wav\isolated_digits_ti_test_endpt\WOMAN\GC\6A_endpt.wav	mfctest\6_156.mfc
wav\isolated_digits_ti_test_endpt\WOMAN\GC\6B_endpt.wav	mfctest\6_157.mfc
wav\isolated_digits_ti_test_endpt\WOMAN\GC\7A_endpt.wav	mfctest\7_156.mfc
wav\isolated_digits_ti_test_endpt\WOMAN\GC\7B_endpt.wav	mfctest\7_157.mfc
wav\isolated_digits_ti_test_endpt\WOMAN\GC\8A_endpt.wav	mfctest\8_156.mfc
wav\isolated_digits_ti_test_endpt\WOMAN\GC\8B_endpt.wav	mfctest\8_157.mfc
wav\isolated_digits_ti_test_endpt\WOMAN\GC\9A_endpt.wav	mfctest\9_156.mfc
wav\isolated_digits_ti_test_endpt\WOMAN\GC\9B_endpt.wav	mfctest\9_157.mfc
wav\isolated_digits_ti_test_endpt\WOMAN\GC\OA_endpt.wav	mfctest\10_156.mfc
wav\isolated_digits_ti_test_endpt\WOMAN\GC\OB_endpt.wav	mfctest\10_157.mfc
wav\isolated_digits_ti_test_endpt\WOMAN\GC\ZA_endpt.wav	mfctest\0_156.mfc
wav\isolated_digits_ti_test_endpt\WOMAN\GC\ZB_endpt.wav	mfctest\0_157.mfc
wav\isolated_digits_ti_test_endpt\WOMAN\GK\1A_endpt.wav	mfctest\1_158.mfc
wav\isolated_digits_ti_test_endpt\WOMAN\GK\1B_endpt.wav	mfctest\1_159.mfc
wav\isolated_digits_ti_test_endpt\WOMAN\GK\2A_endpt.wav	mfctest\2_158.mfc
wav\isolated_digits_ti_test_endpt\WOMAN\GK\2B_endpt.wav	mfctest\2_159.mfc
wav\isolated_digits_ti_test_endpt\WOMAN\GK\3A_endpt.wav	mfctest\3_158.mfc
wav\isolated_digits_ti_test_endpt\WOMAN\GK\3B_endpt.wav	mfctest\3_159.mfc
wav\isolated_digits_ti_test_endpt\WOMAN\GK\4A_endpt.wav	mfctest\4_158.mfc
wav\isolated_digits_ti_test_endpt\WOMAN\GK\4B_endpt.wav	mfctest\4_159.mfc
wav\isolated_digits_ti_test_endpt\WOMAN\GK\5A_endpt.wav	mfctest\5_158.mfc
wav\isolated_digits_ti_test_endpt\WOMAN\GK\5B_endpt.wav	mfctest\5_159.mfc
wav\isolated_digits_ti_test_endpt\WOMAN\GK\6A_endpt.wav	mfctest\6_158.mfc
wav\isolated_digits_ti_test_endpt\WOMAN\GK\6B_endpt.wav	mfctest\6_159.mfc
wav\isolated_digits_ti_test_endpt\WOMAN\GK\7A_endpt.wav	mfctest\7_158.mfc
wav\isolated_digits_ti_test_endpt\WOMAN\GK\7B_endpt.wav	mfctest\7_159.mfc
wav\isolated_digits_ti_test_endpt\WOMAN\GK\8A_endpt.wav	mfctest\8_158.mfc
wav\isolated_digits_ti_test_endpt\WOMAN\GK\8B_endpt.wav	mfctest\8_159.mfc
wav\isolated_digits_ti_test_endpt\WOMAN\GK\9A_endpt.wav	mfctest\9_158.mfc
wav\isolated_digits_ti_test_endpt\WOMAN\GK\9B_endpt.wav	mfctest\9_159.mfc
wav\isolated_digits_ti_test_endpt\WOMAN\GK\OA_endpt.wav	mfctest\10_158.mfc
wav\isolated_digits_ti_test_endpt\WOMAN\GK\OB_endpt.wav	mfctest\10_159.mfc
wav\isolated_digits_ti_test_endpt\WOMAN\GK\ZA_endpt.wav	mfctest\0_158.mfc
wav\isolated_digits_ti_test_endpt\WOMAN\GK\ZB_endpt.wav	mfctest\0_159.mfc
wav\isolated_digits_ti_test_endpt\WOMAN\GL\1A_endpt.wav	mfctest\1_160.mfc
wav\isolated_digits_ti_test_endpt\WOMAN\GL\1B_endpt.wav	mfctest\1_161.mfc
wav\isolated_digits_ti_test_endpt\WOMAN\GL\2A_endpt.wav	mfctest\2_160.mfc
wav\isolated_digits_ti_test_endpt\WOMAN\GL\2B_endpt.wav	mfctest\2_161.mfc
wav\isolated_digits_ti_test_endpt\WOMAN\GL\3A_endpt.wav	mfctest\3_160.mfc
wav\isolated_digits_ti_test_endpt\WOMAN\GL\3B_endpt.wav	mfctest\3_161.mfc
wav\isolated_digits_ti_test_endpt\WOMAN\GL\4A_endpt.wav	mfctest\4_160.mfc
wav\isolated_digits_ti_test_endpt\WOMAN\GL\4B_endpt.wav	mfctest\4_161.mfc
wav\isolated_digits_ti_test_endpt\WOMAN\GL\5A_endpt.wav	mfctest\5_160.mfc
wav\isolated_digits_ti_test_endpt\WOMAN\GL\5B_endpt.wav	mfctest\5_161.mfc
wav\isolated_digits_ti_test_endpt\WOMAN\GL\6A_endpt.wav	mfctest\6_160.mfc
wav\isolated_digits_ti_test_endpt\WOMAN\GL\6B_endpt.wav	mfctest\6_161.mfc
wav\isolated_digits_ti_test_endpt\WOMAN\GL\7A_endpt.wav	mfctest\7_160.mfc
wav\isolated_digits_ti_test_endpt\WOMAN\GL\7B_endpt.wav	mfctest\7_161.mfc
wav\isolated_digits_ti_test_endpt\WOMAN\GL\8A_endpt.wav	mfctest\8_160.mfc
wav\isolated_digits_ti_test_endpt\WOMAN\GL\8B_endpt.wav	mfctest\8_161.mfc
wav\isolated_digits_ti_test_endpt\WOMAN\GL\9A_endpt.wav	mfctest\9_160.mfc
wav\isolated_digits_ti_test_endpt\WOMAN\GL\9B_endpt.wav	mfctest\9_161.mfc
wav\isolated_digits_ti_test_endpt\WOMAN\GL\OA_endpt.wav	mfctest\10_160.mfc
wav\isolated_digits_ti_test_endpt\WOMAN\GL\OB_endpt.wav	mfctest\10_161.mfc
wav\isolated_digits_ti_test_endpt\WOMAN\GL\ZA_endpt.wav	mfctest\0_160.mfc
wav\isolated_digits_ti_test_endpt\WOMAN\GL\ZB_endpt.wav	mfctest\0_161.mfc
wav\isolated_digits_ti_test_endpt\WOMAN\GM\1A_endpt.wav	mfctest\1_162.mfc
wav\isolated_digits_ti_test_endpt\WOMAN\GM\1B_endpt.wav	mfctest\1_163.mfc
wav\isolated_digits_ti_test_endpt\WOMAN\GM\2A_endpt.wav	mfctest\2_162.mfc
wav\isolated_digits_ti_test_endpt\WOMAN\GM\2B_endpt.wav	mfctest\2_163.mfc
wav\isolated_digits_ti_test_endpt\WOMAN\GM\3A_endpt.wav	mfctest\3_162.mfc
wav\isolated_digits_ti_test_endpt\WOMAN\GM\3B_endpt.wav	mfctest\3_163.mfc
wav\isolated_digits_ti_test_endpt\WOMAN\GM\4A_endpt.wav	mfctest\4_162.mfc
wav\isolated_digits_ti_test_endpt\WOMAN\GM\4B_endpt.wav	mfctest\4_163.mfc
wav\isolated_digits_ti_test_endpt\WOMAN\GM\5A_endpt.wav	mfctest\5_162.mfc
wav\isolated_digits_ti_test_endpt\WOMAN\GM\5B_endpt.wav	mfctest\5_163.mfc
wav\isolated_digits_ti_test_endpt\WOMAN\GM\6A_endpt.wav	mfctest\6_162.mfc
wav\isolated_digits_ti_test_endpt\WOMAN\GM\6B_endpt.wav	mfctest\6_163.mfc
wav\isolated_digits_ti_test_endpt\WOMAN\GM\7A_endpt.wav	mfctest\7_162.mfc
wav\isolated_digits_ti_test_endpt\WOMAN\GM\7B_endpt.wav	mfctest\7_163.mfc
wav\isolated_digits_ti_test_endpt\WOMAN\GM\8A_endpt.wav	mfctest\8_162.mfc
wav\isolated_digits_ti_test_endpt\WOMAN\GM\8B_endpt.wav	mfctest\8_163.mfc
wav\isolated_digits_ti_test_endpt\WOMAN\GM\9A_endpt.wav	mfctest\9_162.mfc
wav\isolated_digits_ti_test_endpt\WOMAN\GM\9B_endpt.wav	mfctest\9_163.mfc
wav\isolated_digits_ti_test_endpt\WOMAN\GM\OA_endpt.wav	mfctest\10_162.mfc
wav\isolated_digits_ti_test_endpt\WOMAN\GM\OB_endpt.wav	mfctest\10_163.mfc
wav\isolated_digits_ti_test_endpt\WOMAN\GM\ZA_endpt.wav	mfctest\0_162.mfc
wav\isolated_digits_ti_test_endpt\WOMAN\GM\ZB_endpt.wav	mfctest\0_163.mfc
wav\isolated_digits_ti_test_endpt\WOMAN\GN\1A_endpt.wav	mfctest\1_164.mfc
wav\isolated_digits_ti_test_endpt\WOMAN\GN\1B_endpt.wav	mfctest\1_165.mfc
wav\isolated_digits_ti_test_endpt\WOMAN\GN\2A_endpt.wav	mfctest\2_164.mfc
wav\isolated_digits_ti_test_endpt\WOMAN\GN\2B_endpt.wav	mfctest\2_165.mfc
wav\isolated_digits_ti_test_endpt\WOMAN\GN\3A_endpt.wav	mfctest\3_164.mfc
wav\isolated_digits_ti_test_endpt\WOMAN\GN\3B_endpt.wav	mfctest\3_165.mfc
wav\isolated_digits_ti_test_endpt\WOMAN\GN\4A_endpt.wav	mfctest\4_164.mfc
wav\isolated_digits_ti_test_endpt\WOMAN\GN\4B_endpt.wav	mfctest\4_165.mfc
wav\isolated_digits_ti_test_endpt\WOMAN\GN\5A_endpt.wav	mfctest\5_164.mfc
wav\isolated_digits_ti_test_endpt\WOMAN\GN\5B_endpt.wav	mfctest\5_165.mfc
wav\isolated_digits_ti_test_endpt\WOMAN\GN\6A_endpt.wav	mfctest\6_164.mfc
wav\isolated_digits_ti_test_endpt\WOMAN\GN\6B_endpt.wav	mfctest\6_165.mfc
wav\isolated_digits_ti_test_endpt\WOMAN\GN\7A_endpt.wav	mfctest\7_164.mfc
wav\isolated_digits_ti_test_endpt\WOMAN\GN\7B_endpt.wav	mfctest\7_165.mfc
wav\isolated_digits_ti_test_endpt\WOMAN\GN\8A_endpt.wav	mfctest\8_164.mfc
wav\isolated_digits_ti_test_endpt\WOMAN\GN\8B_endpt.wav	mfctest\8_165.mfc
wav\isolated_digits_ti_test_endpt\WOMAN\GN\9A_endpt.wav	mfctest\9_164.mfc
wav\isolated_digits_ti_test_endpt\WOMAN\GN\9B_endpt.wav	mfctest\9_165.mfc
wav\isolated_digits_ti_test_endpt\WOMAN\GN\OA_endpt.wav	mfctest\10_164.mfc
wav\isolated_digits_ti_test_endpt\WOMAN\GN\OB_endpt.wav	mfctest\10_165.mfc
wav\isolated_digits_ti_test_endpt\WOMAN\GN\ZA_endpt.wav	mfctest\0_164.mfc
wav\isolated_digits_ti_test_endpt\WOMAN\GN\ZB_endpt.wav	mfctest\0_165.mfc
wav\isolated_digits_ti_test_endpt\WOMAN\HF\1A_endpt.wav	mfctest\1_166.mfc
wav\isolated_digits_ti_test_endpt\WOMAN\HF\1B_endpt.wav	mfctest\1_167.mfc
wav\isolated_digits_ti_test_endpt\WOMAN\HF\2A_endpt.wav	mfctest\2_166.mfc
wav\isolated_digits_ti_test_endpt\WOMAN\HF\2B_endpt.wav	mfctest\2_167.mfc
wav\isolated_digits_ti_test_endpt\WOMAN\HF\3A_endpt.wav	mfctest\3_166.mfc
wav\isolated_digits_ti_test_endpt\WOMAN\HF\3B_endpt.wav	mfctest\3_167.mfc
wav\isolated_digits_ti_test_endpt\WOMAN\HF\4A_endpt.wav	mfctest\4_166.mfc
wav\isolated_digits_ti_test_endpt\WOMAN\HF\4B_endpt.wav	mfctest\4_167.mfc
wav\isolated_digits_ti_test_endpt\WOMAN\HF\5A_endpt.wav	mfctest\5_166.mfc
wav\isolated_digits_ti_test_endpt\WOMAN\HF\5B_endpt.wav	mfctest\5_167.mfc
wav\isolated_digits_ti_test_endpt\WOMAN\HF\6A_endpt.wav	mfctest\6_166.mfc
wav\isolated_digits_ti_test_endpt\WOMAN\HF\6B_endpt.wav	mfctest\6_167.mfc
wav\isolated_digits_ti_test_endpt\WOMAN\HF\7A_endpt.wav	mfctest\7_166.mfc
wav\isolated_digits_ti_test_endpt\WOMAN\HF\7B_endpt.wav	mfctest\7_167.mfc
wav\isolated_digits_ti_test_endpt\WOMAN\HF\8A_endpt.wav	mfctest\8_166.mfc
wav\isolated_digits_ti_test_endpt\WOMAN\HF\8B_endpt.wav	mfctest\8_167.mfc
wav\isolated_digits_ti_test_endpt\WOMAN\HF\9A_endpt.wav	mfctest\9_166.mfc
wav\isolated_digits_ti_test_endpt\WOMAN\HF\9B_endpt.wav	mfctest\9_167.mfc
wav\isolated_digits_ti_test_endpt\WOMAN\HF\OA_endpt.wav	mfctest\10_166.mfc
wav\isolated_digits_ti_test_endpt\WOMAN\HF\OB_endpt.wav	mfctest\10_167.mfc
wav\isolated_digits_ti_test_endpt\WOMAN\HF\ZA_endpt.wav	mfctest\0_166.mfc
wav\isolated_digits_ti_test_endpt\WOMAN\HF\ZB_endpt.wav	mfctest\0_167.mfc
wav\isolated_digits_ti_test_endpt\WOMAN\ID\1A_endpt.wav	mfctest\1_168.mfc
wav\isolated_digits_ti_test_endpt\WOMAN\ID\1B_endpt.wav	mfctest\1_169.mfc
wav\isolated_digits_ti_test_endpt\WOMAN\ID\2A_endpt.wav	mfctest\2_168.mfc
wav\isolated_digits_ti_test_endpt\WOMAN\ID\2B_endpt.wav	mfctest\2_169.mfc
wav\isolated_digits_ti_test_endpt\WOMAN\ID\3A_endpt.wav	mfctest\3_168.mfc
wav\isolated_digits_ti_test_endpt\WOMAN\ID\3B_endpt.wav	mfctest\3_169.mfc
wav\isolated_digits_ti_test_endpt\WOMAN\ID\4A_endpt.wav	mfctest\4_168.mfc
wav\isolated_digits_ti_test_endpt\WOMAN\ID\4B_endpt.wav	mfctest\4_169.mfc
wav\isolated_digits_ti_test_endpt\WOMAN\ID\5A_endpt.wav	mfctest\5_168.mfc
wav\isolated_digits_ti_test_endpt\WOMAN\ID\5B_endpt.wav	mfctest\5_169.mfc
wav\isolated_digits_ti_test_endpt\WOMAN\ID\6A_endpt.wav	mfctest\6_168.mfc
wav\isolated_digits_ti_test_endpt\WOMAN\ID\6B_endpt.wav	mfctest\6_169.mfc
wav\isolated_digits_ti_test_endpt\WOMAN\ID\7A_endpt.wav	mfctest\7_168.mfc
wav\isolated_digits_ti_test_endpt\WOMAN\ID\7B_endpt.wav	mfctest\7_169.mfc
wav\isolated_digits_ti_test_endpt\WOMAN\ID\8A_endpt.wav	mfctest\8_168.mfc
wav\isolated_digits_ti_test_endpt\WOMAN\ID\8B_endpt.wav	mfctest\8_169.mfc
wav\isolated_digits_ti_test_endpt\WOMAN\ID\9A_endpt.wav	mfctest\9_168.mfc
wav\isolated_digits_ti_test_endpt\WOMAN\ID\9B_endpt.wav	mfctest\9_169.mfc
wav\isolated_digits_ti_test_endpt\WOMAN\ID\OA_endpt.wav	mfctest\10_168.mfc
wav\isolated_digits_ti_test_endpt\WOMAN\ID\OB_endpt.wav	mfctest\10_169.mfc
wav\isolated_digits_ti_test_endpt\WOMAN\ID\ZA_endpt.wav	mfctest\0_168.mfc
wav\isolated_digits_ti_test_endpt\WOMAN\ID\ZB_endpt.wav	mfctest\0_169.mfc
wav\isolated_digits_ti_test_endpt\WOMAN\II\1A_endpt.wav	mfctest\1_170.mfc
wav\isolated_digits_ti_test_endpt\WOMAN\II\1B_endpt.wav	mfctest\1_171.mfc
wav\isolated_digits_ti_test_endpt\WOMAN\II\2A_endpt.wav	mfctest\2_170.mfc
wav\isolated_digits_ti_test_endpt\WOMAN\II\2B_endpt.wav	mfctest\2_171.mfc
wav\isolated_digits_ti_test_endpt\WOMAN\II\3A_endpt.wav	mfctest\3_170.mfc
wav\isolated_digits_ti_test_endpt\WOMAN\II\3B_endpt.wav	mfctest\3_171.mfc
wav\isolated_digits_ti_test_endpt\WOMAN\II\4A_endpt.wav	mfctest\4_170.mfc
wav\isolated_digits_ti_test_endpt\WOMAN\II\4B_endpt.wav	mfctest\4_171.mfc
wav\isolated_digits_ti_test_endpt\WOMAN\II\5A_endpt.wav	mfctest\5_170.mfc
wav\isolated_digits_ti_test_endpt\WOMAN\II\5B_endpt.wav	mfctest\5_171.mfc
wav\isolated_digits_ti_test_endpt\WOMAN\II\6A_endpt.wav	mfctest\6_170.mfc
wav\isolated_digits_ti_test_endpt\WOMAN\II\6B_endpt.wav	mfctest\6_171.mfc
wav\isolated_digits_ti_test_endpt\WOMAN\II\7A_endpt.wav	mfctest\7_170.mfc
wav\isolated_digits_ti_test_endpt\WOMAN\II\7B_endpt.wav	mfctest\7_171.mfc
wav\isolated_digits_ti_test_endpt\WOMAN\II\8A_endpt.wav	mfctest\8_170.mfc
wav\isolated_digits_ti_test_endpt\WOMAN\II\8B_endpt.wav	mfctest\8_171.mfc
wav\isolated_digits_ti_test_endpt\WOMAN\II\9A_endpt.wav	mfctest\9_170.mfc
wav\isolated_digits_ti_test_endpt\WOMAN\II\9B_endpt.wav	mfctest\9_171.mfc
wav\isolated_digits_ti_test_endpt\WOMAN\II\OA_endpt.wav	mfctest\10_170.mfc
wav\isolated_digits_ti_test_endpt\WOMAN\II\OB_endpt.wav	mfctest\10_171.mfc
wav\isolated_digits_ti_test_endpt\WOMAN\II\ZA_endpt.wav	mfctest\0_170.mfc
wav\isolated_digits_ti_test_endpt\WOMAN\II\ZB_endpt.wav	mfctest\0_171.mfc
wav\isolated_digits_ti_test_endpt\WOMAN\IW\1A_endpt.wav	mfctest\1_172.mfc
wav\isolated_digits_ti_test_endpt\WOMAN\IW\1B_endpt.wav	mfctest\1_173.mfc
wav\isolated_digits_ti_test_endpt\WOMAN\IW\2A_endpt.wav	mfctest\2_172.mfc
wav\isolated_digits_ti_test_endpt\WOMAN\IW\2B_endpt.wav	mfctest\2_173.mfc
wav\isolated_digits_ti_test_endpt\WOMAN\IW\3A_endpt.wav	mfctest\3_172.mfc
wav\isolated_digits_ti_test_endpt\WOMAN\IW\3B_endpt.wav	mfctest\3_173.mfc
wav\isolated_digits_ti_test_endpt\WOMAN\IW\4A_endpt.wav	mfctest\4_172.mfc
wav\isolated_digits_ti_test_endpt\WOMAN\IW\4B_endpt.wav	mfctest\4_173.mfc
wav\isolated_digits_ti_test_endpt\WOMAN\IW\5A_endpt.wav	mfctest\5_172.mfc
wav\isolated_digits_ti_test_endpt\WOMAN\IW\5B_endpt.wav	mfctest\5_173.mfc
wav\isolated_digits_ti_test_endpt\WOMAN\IW\6A_endpt.wav	mfctest\6_172.mfc
wav\isolated_digits_ti_test_endpt\WOMAN\IW\6B_endpt.wav	mfctest\6_173.mfc
wav\isolated_digits_ti_test_endpt\WOMAN\IW\7A_endpt.wav	mfctest\7_172.mfc
wav\isolated_digits_ti_test_endpt\WOMAN\IW\7B_endpt.wav	mfctest\7_173.mfc
wav\isolated_digits_ti_test_endpt\WOMAN\IW\8A_endpt.wav	mfctest\8_172.mfc
wav\isolated_digits_ti_test_endpt\WOMAN\IW\8B_endpt.wav	mfctest\8_173.mfc
wav\isolated_digits_ti_test_endpt\WOMAN\IW\9A_endpt.wav	mfctest\9_172.mfc
wav\isolated_digits_ti_test_endpt\WOMAN\IW\9B_endpt.wav	mfctest\9_173.mfc
wav\isolated_digits_ti_test_endpt\WOMAN\IW\OA_endpt.wav	mfctest\10_172.mfc
wav\isolated_digits_ti_test_endpt\WOMAN\IW\OB_endpt.wav	mfctest\10_173.mfc
wav\isolated_digits_ti_test_endpt\WOMAN\IW\ZA_endpt.wav	mfctest\0_172.mfc
wav\isolated_digits_ti_test_endpt\WOMAN\IW\ZB_endpt.wav	mfctest\0_173.mfc
wav\isolated_digits_ti_test_endpt\WOMAN\JD\1A_endpt.wav	mfctest\1_174.mfc
wav\isolated_digits_ti_test_endpt\WOMAN\JD\1B_endpt.wav	mfctest\1_175.mfc
wav\isolated_digits_ti_test_endpt\WOMAN\JD\2A_endpt.wav	mfctest\2_174.mfc
wav\isolated_digits_ti_test_endpt\WOMAN\JD\2B_endpt.wav	mfctest\2_175.mfc
wav\isolated_digits_ti_test_endpt\WOMAN\JD\3A_endpt.wav	mfctest\3_174.mfc
wav\isolated_digits_ti_test_endpt\WOMAN\JD\3B_endpt.wav	mfctest\3_175.mfc
wav\isolated_digits_ti_test_endpt\WOMAN\JD\4A_endpt.wav	mfctest\4_174.mfc
wav\isolated_digits_ti_test_endpt\WOMAN\JD\4B_endpt.wav	mfctest\4_175.mfc
wav\isolated_digits_ti_test_endpt\WOMAN\JD\5A_endpt.wav	mfctest\5_174.mfc
wav\isolated_digits_ti_test_endpt\WOMAN\JD\5B_endpt.wav	mfctest\5_175.mfc
wav\isolated_digits_ti_test_endpt\WOMAN\JD\6A_endpt.wav	mfctest\6_174.mfc
wav\isolated_digits_ti_test_endpt\WOMAN\JD\6B_endpt.wav	mfctest\6_175.mfc
wav\isolated_digits_ti_test_endpt\WOMAN\JD\7A_endpt.wav	mfctest\7_174.mfc
wav\isolated_digits_ti_test_endpt\WOMAN\JD\7B_endpt.wav	mfctest\7_175.mfc
wav\isolated_digits_ti_test_endpt\WOMAN\JD\8A_endpt.wav	mfctest\8_174.mfc
wav\isolated_digits_ti_test_endpt\WOMAN\JD\8B_endpt.wav	mfctest\8_175.mfc
wav\isolated_digits_ti_test_endpt\WOMAN\JD\9A_endpt.wav	mfctest\9_174.mfc
wav\isolated_digits_ti_test_endpt\WOMAN\JD\9B_endpt.wav	mfctest\9_175.mfc
wav\isolated_digits_ti_test_endpt\WOMAN\JD\OA_endpt.wav	mfctest\10_174.mfc
wav\isolated_digits_ti_test_endpt\WOMAN\JD\OB_endpt.wav	mfctest\10_175.mfc
wav\isolated_digits_ti_test_endpt\WOMAN\JD\ZA_endpt.wav	mfctest\0_174.mfc
wav\isolated_digits_ti_test_endpt\WOMAN\JD\ZB_endpt.wav	mfctest\0_175.mfc
wav\isolated_digits_ti_test_endpt\WOMAN\JE\1A_endpt.wav	mfctest\1_176.mfc
wav\isolated_digits_ti_test_endpt\WOMAN\JE\1B_endpt.wav	mfctest\1_177.mfc
wav\isolated_digits_ti_test_endpt\WOMAN\JE\2A_endpt.wav	mfctest\2_176.mfc
wav\isolated_digits_ti_test_endpt\WOMAN\JE\2B_endpt.wav	mfctest\2_177.mfc
wav\isolated_digits_ti_test_endpt\WOMAN\JE\3A_endpt.wav	mfctest\3_176.mfc
wav\isolated_digits_ti_test_endpt\WOMAN\JE\3B_endpt.wav	mfctest\3_177.mfc
wav\isolated_digits_ti_test_endpt\WOMAN\JE\4A_endpt.wav	mfctest\4_176.mfc
wav\isolated_digits_ti_test_endpt\WOMAN\JE\4B_endpt.wav	mfctest\4_177.mfc
wav\isolated_digits_ti_test_endpt\WOMAN\JE\5A_endpt.wav	mfctest\5_176.mfc
wav\isolated_digits_ti_test_endpt\WOMAN\JE\5B_endpt.wav	mfctest\5_177.mfc
wav\isolated_digits_ti_test_endpt\WOMAN\JE\6A_endpt.wav	mfctest\6_176.mfc
wav\isolated_digits_ti_test_endpt\WOMAN\JE\6B_endpt.wav	mfctest\6_177.mfc
wav\isolated_digits_ti_test_endpt\WOMAN\JE\7A_endpt.wav	mfctest\7_176.mfc
wav\isolated_digits_ti_test_endpt\WOMAN\JE\7B_endpt.wav	mfctest\7_177.mfc
wav\isolated_digits_ti_test_endpt\WOMAN\JE\8A_endpt.wav	mfctest\8_176.mfc
wav\isolated_digits_ti_test_endpt\WOMAN\JE\8B_endpt.wav	mfctest\8_177.mfc
wav\isolated_digits_ti_test_endpt\WOMAN\JE\9A_endpt.wav	mfctest\9_176.mfc
wav\isolated_digits_ti_test_endpt\WOMAN\JE\9B_endpt.wav	mfctest\9_177.mfc
wav\isolated_digits_ti_test_endpt\WOMAN\JE\OA_endpt.wav	mfctest\10_176.mfc
wav\isolated_digits_ti_test_endpt\WOMAN\JE\OB_endpt.wav	mfctest\10_177.mfc
wav\isolated_digits_ti_test_endpt\WOMAN\JE\ZA_endpt.wav	mfctest\0_176.mfc
wav\isolated_digits_ti_test_endpt\WOMAN\JE\ZB_endpt.wav	mfctest\0_177.mfc
wav\isolated_digits_ti_test_endpt\WOMAN\JW\1A_endpt.wav	mfctest\1_178.mfc
wav\isolated_digits_ti_test_endpt\WOMAN\JW\1B_endpt.wav	mfctest\1_179.mfc
wav\isolated_digits_ti_test_endpt\WOMAN\JW\2A_endpt.wav	mfctest\2_178.mfc
wav\isolated_digits_ti_test_endpt\WOMAN\JW\2B_endpt.wav	mfctest\2_179.mfc
wav\isolated_digits_ti_test_endpt\WOMAN\JW\3A_endpt.wav	mfctest\3_178.mfc
wav\isolated_digits_ti_test_endpt\WOMAN\JW\3B_endpt.wav	mfctest\3_179.mfc
wav\isolated_digits_ti_test_endpt\WOMAN\JW\4A_endpt.wav	mfctest\4_178.mfc
wav\isolated_digits_ti_test_endpt\WOMAN\JW\4B_endpt.wav	mfctest\4_179.mfc
wav\isolated_digits_ti_test_endpt\WOMAN\JW\5A_endpt.wav	mfctest\5_178.mfc
wav\isolated_digits_ti_test_endpt\WOMAN\JW\5B_endpt.wav	mfctest\5_179.mfc
wav\isolated_digits_ti_test_endpt\WOMAN\JW\6A_endpt.wav	mfctest\6_178.mfc
wav\isolated_digits_ti_test_endpt\WOMAN\JW\6B_endpt.wav	mfctest\6_179.mfc
wav\isolated_digits_ti_test_endpt\WOMAN\JW\7A_endpt.wav	mfctest\7_178.mfc
wav\isolated_digits_ti_test_endpt\WOMAN\JW\7B_endpt.wav	mfctest\7_179.mfc
wav\isolated_digits_ti_test_endpt\WOMAN\JW\8A_endpt.wav	mfctest\8_178.mfc
wav\isolated_digits_ti_test_endpt\WOMAN\JW\8B_endpt.wav	mfctest\8_179.mfc
wav\isolated_digits_ti_test_endpt\WOMAN\JW\9A_endpt.wav	mfctest\9_178.mfc
wav\isolated_digits_ti_test_endpt\WOMAN\JW\9B_endpt.wav	mfctest\9_179.mfc
wav\isolated_digits_ti_test_endpt\WOMAN\JW\OA_endpt.wav	mfctest\10_178.mfc
wav\isolated_digits_ti_test_endpt\WOMAN\JW\OB_endpt.wav	mfctest\10_179.mfc
wav\isolated_digits_ti_test_endpt\WOMAN\JW\ZA_endpt.wav	mfctest\0_178.mfc
wav\isolated_digits_ti_test_endpt\WOMAN\JW\ZB_endpt.wav	mfctest\0_179.mfc
wav\isolated_digits_ti_test_endpt\WOMAN\KB\1A_endpt.wav	mfctest\1_180.mfc
wav\isolated_digits_ti_test_endpt\WOMAN\KB\1B_endpt.wav	mfctest\1_181.mfc
wav\isolated_digits_ti_test_endpt\WOMAN\KB\2A_endpt.wav	mfctest\2_180.mfc
wav\isolated_digits_ti_test_endpt\WOMAN\KB\2B_endpt.wav	mfctest\2_181.mfc
wav\isolated_digits_ti_test_endpt\WOMAN\KB\3A_endpt.wav	mfctest\3_180.mfc
wav\isolated_digits_ti_test_endpt\WOMAN\KB\3B_endpt.wav	mfctest\3_181.mfc
wav\isolated_digits_ti_test_endpt\WOMAN\KB\4A_endpt.wav	mfctest\4_180.mfc
wav\isolated_digits_ti_test_endpt\WOMAN\KB\4B_endpt.wav	mfctest\4_181.mfc
wav\isolated_digits_ti_test_endpt\WOMAN\KB\5A_endpt.wav	mfctest\5_180.mfc
wav\isolated_digits_ti_test_endpt\WOMAN\KB\5B_endpt.wav	mfctest\5_181.mfc
wav\isolated_digits_ti_test_endpt\WOMAN\KB\6A_endpt.wav	mfctest\6_180.mfc
wav\isolated_digits_ti_test_endpt\WOMAN\KB\6B_endpt.wav	mfctest\6_181.mfc
wav\isolated_digits_ti_test_endpt\WOMAN\KB\7A_endpt.wav	mfctest\7_180.mfc
wav\isolated_digits_ti_test_endpt\WOMAN\KB\7B_endpt.wav	mfctest\7_181.mfc
wav\isolated_digits_ti_test_endpt\WOMAN\KB\8A_endpt.wav	mfctest\8_180.mfc
wav\isolated_digits_ti_test_endpt\WOMAN\KB\8B_endpt.wav	mfctest\8_181.mfc
wav\isolated_digits_ti_test_endpt\WOMAN\KB\9A_endpt.wav	mfctest\9_180.mfc
wav\isolated_digits_ti_test_endpt\WOMAN\KB\9B_endpt.wav	mfctest\9_181.mfc
wav\isolated_digits_ti_test_endpt\WOMAN\KB\OA_endpt.wav	mfctest\10_180.mfc
wav\isolated_digits_ti_test_endpt\WOMAN\KB\OB_endpt.wav	mfctest\10_181.mfc
wav\isolated_digits_ti_test_endpt\WOMAN\KB\ZA_endpt.wav	mfctest\0_180.mfc
wav\isolated_digits_ti_test_endpt\WOMAN\KB\ZB_endpt.wav	mfctest\0_181.mfc
wav\isolated_digits_ti_test_endpt\WOMAN\KJ\1A_endpt.wav	mfctest\1_182.mfc
wav\isolated_digits_ti_test_endpt\WOMAN\KJ\1B_endpt.wav	mfctest\1_183.mfc
wav\isolated_digits_ti_test_endpt\WOMAN\KJ\2A_endpt.wav	mfctest\2_182.mfc
wav\isolated_digits_ti_test_endpt\WOMAN\KJ\2B_endpt.wav	mfctest\2_183.mfc
wav\isolated_digits_ti_test_endpt\WOMAN\KJ\3A_endpt.wav	mfctest\3_182.mfc
wav\isolated_digits_ti_test_endpt\WOMAN\KJ\3B_endpt.wav	mfctest\3_183.mfc
wav\isolated_digits_ti_test_endpt\WOMAN\KJ\4A_endpt.wav	mfctest\4_182.mfc
wav\isolated_digits_ti_test_endpt\WOMAN\KJ\4B_endpt.wav	mfctest\4_183.mfc
wav\isolated_digits_ti_test_endpt\WOMAN\KJ\5A_endpt.wav	mfctest\5_182.mfc
wav\isolated_digits_ti_test_endpt\WOMAN\KJ\5B_endpt.wav	mfctest\5_183.mfc
wav\isolated_digits_ti_test_endpt\WOMAN\KJ\6A_endpt.wav	mfctest\6_182.mfc
wav\isolated_digits_ti_test_endpt\WOMAN\KJ\6B_endpt.wav	mfctest\6_183.mfc
wav\isolated_digits_ti_test_endpt\WOMAN\KJ\7A_endpt.wav	mfctest\7_182.mfc
wav\isolated_digits_ti_test_endpt\WOMAN\KJ\7B_endpt.wav	mfctest\7_183.mfc
wav\isolated_digits_ti_test_endpt\WOMAN\KJ\8A_endpt.wav	mfctest\8_182.mfc
wav\isolated_digits_ti_test_endpt\WOMAN\KJ\8B_endpt.wav	mfctest\8_183.mfc
wav\isolated_digits_ti_test_endpt\WOMAN\KJ\9A_endpt.wav	mfctest\9_182.mfc
wav\isolated_digits_ti_test_endpt\WOMAN\KJ\9B_endpt.wav	mfctest\9_183.mfc
wav\isolated_digits_ti_test_endpt\WOMAN\KJ\OA_endpt.wav	mfctest\10_182.mfc
wav\isolated_digits_ti_test_endpt\WOMAN\KJ\OB_endpt.wav	mfctest\10_183.mfc
wav\isolated_digits_ti_test_endpt\WOMAN\KJ\ZA_endpt.wav	mfctest\0_182.mfc
wav\isolated_digits_ti_test_endpt\WOMAN\KJ\ZB_endpt.wav	mfctest\0_183.mfc
wav\isolated_digits_ti_test_endpt\WOMAN\LJ\1A_endpt.wav	mfctest\1_184.mfc
wav\isolated_digits_ti_test_endpt\WOMAN\LJ\1B_endpt.wav	mfctest\1_185.mfc
wav\isolated_digits_ti_test_endpt\WOMAN\LJ\2A_endpt.wav	mfctest\2_184.mfc
wav\isolated_digits_ti_test_endpt\WOMAN\LJ\2B_endpt.wav	mfctest\2_185.mfc
wav\isolated_digits_ti_test_endpt\WOMAN\LJ\3A_endpt.wav	mfctest\3_184.mfc
wav\isolated_digits_ti_test_endpt\WOMAN\LJ\3B_endpt.wav	mfctest\3_185.mfc
wav\isolated_digits_ti_test_endpt\WOMAN\LJ\4A_endpt.wav	mfctest\4_184.mfc
wav\isolated_digits_ti_test_endpt\WOMAN\LJ\4B_endpt.wav	mfctest\4_185.mfc
wav\isolated_digits_ti_test_endpt\WOMAN\LJ\5A_endpt.wav	mfctest\5_184.mfc
wav\isolated_digits_ti_test_endpt\WOMAN\LJ\5B_endpt.wav	mfctest\5_185.mfc
wav\isolated_digits_ti_test_endpt\WOMAN\LJ\6A_endpt.wav	mfctest\6_184.mfc
wav\isolated_digits_ti_test_endpt\WOMAN\LJ\6B_endpt.wav	mfctest\6_185.mfc
wav\isolated_digits_ti_test_endpt\WOMAN\LJ\7A_endpt.wav	mfctest\7_184.mfc
wav\isolated_digits_ti_test_endpt\WOMAN\LJ\7B_endpt.wav	mfctest\7_185.mfc
wav\isolated_digits_ti_test_endpt\WOMAN\LJ\8A_endpt.wav	mfctest\8_184.mfc
wav\isolated_digits_ti_test_endpt\WOMAN\LJ\8B_endpt.wav	mfctest\8_185.mfc
wav\isolated_digits_ti_test_endpt\WOMAN\LJ\9A_endpt.wav	mfctest\9_184.mfc
wav\isolated_digits_ti_test_endpt\WOMAN\LJ\9B_endpt.wav	mfctest\9_185.mfc
wav\isolated_digits_ti_test_endpt\WOMAN\LJ\OA_endpt.wav	mfctest\10_184.mfc
wav\isolated_digits_ti_test_endpt\WOMAN\LJ\OB_endpt.wav	mfctest\10_185.mfc
wav\isolated_digits_ti_test_endpt\WOMAN\LJ\ZA_endpt.wav	mfctest\0_184.mfc
wav\isolated_digits_ti_test_endpt\WOMAN\LJ\ZB_endpt.wav	mfctest\0_185.mfc
wav\isolated_digits_ti_test_endpt\WOMAN\LL\1A_endpt.wav	mfctest\1_186.mfc
wav\isolated_digits_ti_test_endpt\WOMAN\LL\1B_endpt.wav	mfctest\1_187.mfc
wav\isolated_digits_ti_test_endpt\WOMAN\LL\2A_endpt.wav	mfctest\2_186.mfc
wav\isolated_digits_ti_test_endpt\WOMAN\LL\2B_endpt.wav	mfctest\2_187.mfc
wav\isolated_digits_ti_test_endpt\WOMAN\LL\3A_endpt.wav	mfctest\3_186.mfc
wav\isolated_digits_ti_test_endpt\WOMAN\LL\3B_endpt.wav	mfctest\3_187.mfc
wav\isolated_digits_ti_test_endpt\WOMAN\LL\4A_endpt.wav	mfctest\4_186.mfc
wav\isolated_digits_ti_test_endpt\WOMAN\LL\4B_endpt.wav	mfctest\4_187.mfc
wav\isolated_digits_ti_test_endpt\WOMAN\LL\5A_endpt.wav	mfctest\5_186.mfc
wav\isolated_digits_ti_test_endpt\WOMAN\LL\5B_endpt.wav	mfctest\5_187.mfc
wav\isolated_digits_ti_test_endpt\WOMAN\LL\6A_endpt.wav	mfctest\6_186.mfc
wav\isolated_digits_ti_test_endpt\WOMAN\LL\6B_endpt.wav	mfctest\6_187.mfc
wav\isolated_digits_ti_test_endpt\WOMAN\LL\7A_endpt.wav	mfctest\7_186.mfc
wav\isolated_digits_ti_test_endpt\WOMAN\LL\7B_endpt.wav	mfctest\7_187.mfc
wav\isolated_digits_ti_test_endpt\WOMAN\LL\8A_endpt.wav	mfctest\8_186.mfc
wav\isolated_digits_ti_test_endpt\WOMAN\LL\8B_endpt.wav	mfctest\8_187.mfc
wav\isolated_digits_ti_test_endpt\WOMAN\LL\9A_endpt.wav	mfctest\9_186.mfc
wav\isolated_digits_ti_test_endpt\WOMAN\LL\9B_endpt.wav	mfctest\9_187.mfc
wav\isolated_digits_ti_test_endpt\WOMAN\LL\OA_endpt.wav	mfctest\10_186.mfc
wav\isolated_digits_ti_test_endpt\WOMAN\LL\OB_endpt.wav	mfctest\10_187.mfc
wav\isolated_digits_ti_test_endpt\WOMAN\LL\ZA_endpt.wav	mfctest\0_186.mfc
wav\isolated_digits_ti_test_endpt\WOMAN\LL\ZB_endpt.wav	mfctest\0_187.mfc
wav\isolated_digits_ti_test_endpt\WOMAN\LP\1A_endpt.wav	mfctest\1_188.mfc
wav\isolated_digits_ti_test_endpt\WOMAN\LP\1B_endpt.wav	mfctest\1_189.mfc
wav\isolated_digits_ti_test_endpt\WOMAN\LP\2A_endpt.wav	mfctest\2_188.mfc
wav\isolated_digits_ti_test_endpt\WOMAN\LP\2B_endpt.wav	mfctest\2_189.mfc
wav\isolated_digits_ti_test_endpt\WOMAN\LP\3A_endpt.wav	mfctest\3_188.mfc
wav\isolated_digits_ti_test_endpt\WOMAN\LP\3B_endpt.wav	mfctest\3_189.mfc
wav\isolated_digits_ti_test_endpt\WOMAN\LP\4A_endpt.wav	mfctest\4_188.mfc
wav\isolated_digits_ti_test_endpt\WOMAN\LP\4B_endpt.wav	mfctest\4_189.mfc
wav\isolated_digits_ti_test_endpt\WOMAN\LP\5A_endpt.wav	mfctest\5_188.mfc
wav\isolated_digits_ti_test_endpt\WOMAN\LP\5B_endpt.wav	mfctest\5_189.mfc
wav\isolated_digits_ti_test_endpt\WOMAN\LP\6A_endpt.wav	mfctest\6_188.mfc
wav\isolated_digits_ti_test_endpt\WOMAN\LP\6B_endpt.wav	mfctest\6_189.mfc
wav\isolated_digits_ti_test_endpt\WOMAN\LP\7A_endpt.wav	mfctest\7_188.mfc
wav\isolated_digits_ti_test_endpt\WOMAN\LP\7B_endpt.wav	mfctest\7_189.mfc
wav\isolated_digits_ti_test_endpt\WOMAN\LP\8A_endpt.wav	mfctest\8_188.mfc
wav\isolated_digits_ti_test_endpt\WOMAN\LP\8B_endpt.wav	mfctest\8_189.mfc
wav\isolated_digits_ti_test_endpt\WOMAN\LP\9A_endpt.wav	mfctest\9_188.mfc
wav\isolated_digits_ti_test_endpt\WOMAN\LP\9B_endpt.wav	mfctest\9_189.mfc
wav\isolated_digits_ti_test_endpt\WOMAN\LP\OA_endpt.wav	mfctest\10_188.mfc
wav\isolated_digits_ti_test_endpt\WOMAN\LP\OB_endpt.wav	mfctest\10_189.mfc
wav\isolated_digits_ti_test_endpt\WOMAN\LP\ZA_endpt.wav	mfctest\0_188.mfc
wav\isolated_digits_ti_test_endpt\WOMAN\LP\ZB_endpt.wav	mfctest\0_189.mfc
wav\isolated_digits_ti_test_endpt\WOMAN\LR\1A_endpt.wav	mfctest\1_190.mfc
wav\isolated_digits_ti_test_endpt\WOMAN\LR\1B_endpt.wav	mfctest\1_191.mfc
wav\isolated_digits_ti_test_endpt\WOMAN\LR\2A_endpt.wav	mfctest\2_190.mfc
wav\isolated_digits_ti_test_endpt\WOMAN\LR\2B_endpt.wav	mfctest\2_191.mfc
wav\isolated_digits_ti_test_endpt\WOMAN\LR\3A_endpt.wav	mfctest\3_190.mfc
wav\isolated_digits_ti_test_endpt\WOMAN\LR\3B_endpt.wav	mfctest\3_191.mfc
wav\isolated_digits_ti_test_endpt\WOMAN\LR\4A_endpt.wav	mfctest\4_190.mfc
wav\isolated_digits_ti_test_endpt\WOMAN\LR\4B_endpt.wav	mfctest\4_191.mfc
wav\isolated_digits_ti_test_endpt\WOMAN\LR\5A_endpt.wav	mfctest\5_190.mfc
wav\isolated_digits_ti_test_endpt\WOMAN\LR\5B_endpt.wav	mfctest\5_191.mfc
wav\isolated_digits_ti_test_endpt\WOMAN\LR\6A_endpt.wav	mfctest\6_190.mfc
wav\isolated_digits_ti_test_endpt\WOMAN\LR\6B_endpt.wav	mfctest\6_191.mfc
wav\isolated_digits_ti_test_endpt\WOMAN\LR\7A_endpt.wav	mfctest\7_190.mfc
wav\isolated_digits_ti_test_endpt\WOMAN\LR\7B_endpt.wav	mfctest\7_191.mfc
wav\isolated_digits_ti_test_endpt\WOMAN\LR\8A_endpt.wav	mfctest\8_190.mfc
wav\isolated_digits_ti_test_endpt\WOMAN\LR\8B_endpt.wav	mfctest\8_191.mfc
wav\isolated_digits_ti_test_endpt\WOMAN\LR\9A_endpt.wav	mfctest\9_190.mfc
wav\isolated_digits_ti_test_endpt\WOMAN\LR\9B_endpt.wav	mfctest\9_191.mfc
wav\isolated_digits_ti_test_endpt\WOMAN\LR\OA_endpt.wav	mfctest\10_190.mfc
wav\isolated_digits_ti_test_endpt\WOMAN\LR\OB_endpt.wav	mfctest\10_191.mfc
wav\isolated_digits_ti_test_endpt\WOMAN\LR\ZA_endpt.wav	mfctest\0_190.mfc
wav\isolated_digits_ti_test_endpt\WOMAN\LR\ZB_endpt.wav	mfctest\0_191.mfc
wav\isolated_digits_ti_test_endpt\WOMAN\MC\1A_endpt.wav	mfctest\1_192.mfc
wav\isolated_digits_ti_test_endpt\WOMAN\MC\1B_endpt.wav	mfctest\1_193.mfc
wav\isolated_digits_ti_test_endpt\WOMAN\MC\2A_endpt.wav	mfctest\2_192.mfc
wav\isolated_digits_ti_test_endpt\WOMAN\MC\2B_endpt.wav	mfctest\2_193.mfc
wav\isolated_digits_ti_test_endpt\WOMAN\MC\3A_endpt.wav	mfctest\3_192.mfc
wav\isolated_digits_ti_test_endpt\WOMAN\MC\3B_endpt.wav	mfctest\3_193.mfc
wav\isolated_digits_ti_test_endpt\WOMAN\MC\4A_endpt.wav	mfctest\4_192.mfc
wav\isolated_digits_ti_test_endpt\WOMAN\MC\4B_endpt.wav	mfctest\4_193.mfc
wav\isolated_digits_ti_test_endpt\WOMAN\MC\5A_endpt.wav	mfctest\5_192.mfc
wav\isolated_digits_ti_test_endpt\WOMAN\MC\5B_endpt.wav	mfctest\5_193.mfc
wav\isolated_digits_ti_test_endpt\WOMAN\MC\6A_endpt.wav	mfctest\6_192.mfc
wav\isolated_digits_ti_test_endpt\WOMAN\MC\6B_endpt.wav	mfctest\6_193.mfc
wav\isolated_digits_ti_test_endpt\WOMAN\MC\7A_endpt.wav	mfctest\7_192.mfc
wav\isolated_digits_ti_test_endpt\WOMAN\MC\7B_endpt.wav	mfctest\7_193.mfc
wav\isolated_digits_ti_test_endpt\WOMAN\MC\8A_endpt.wav	mfctest\8_192.mfc
wav\isolated_digits_ti_test_endpt\WOMAN\MC\8B_endpt.wav	mfctest\8_193.mfc
wav\isolated_digits_ti_test_endpt\WOMAN\MC\9A_endpt.wav	mfctest\9_192.mfc
wav\isolated_digits_ti_test_endpt\WOMAN\MC\9B_endpt.wav	mfctest\9_193.mfc
wav\isolated_digits_ti_test_endpt\WOMAN\MC\OA_endpt.wav	mfctest\10_192.mfc
wav\isolated_digits_ti_test_endpt\WOMAN\MC\OB_endpt.wav	mfctest\10_193.mfc
wav\isolated_digits_ti_test_endpt\WOMAN\MC\ZA_endpt.wav	mfctest\0_192.mfc
wav\isolated_digits_ti_test_endpt\WOMAN\MC\ZB_endpt.wav	mfctest\0_193.mfc
wav\isolated_digits_ti_test_endpt\WOMAN\MJ\1A_endpt.wav	mfctest\1_194.mfc
wav\isolated_digits_ti_test_endpt\WOMAN\MJ\1B_endpt.wav	mfctest\1_195.mfc
wav\isolated_digits_ti_test_endpt\WOMAN\MJ\2A_endpt.wav	mfctest\2_194.mfc
wav\isolated_digits_ti_test_endpt\WOMAN\MJ\2B_endpt.wav	mfctest\2_195.mfc
wav\isolated_digits_ti_test_endpt\WOMAN\MJ\3A_endpt.wav	mfctest\3_194.mfc
wav\isolated_digits_ti_test_endpt\WOMAN\MJ\3B_endpt.wav	mfctest\3_195.mfc
wav\isolated_digits_ti_test_endpt\WOMAN\MJ\4A_endpt.wav	mfctest\4_194.mfc
wav\isolated_digits_ti_test_endpt\WOMAN\MJ\4B_endpt.wav	mfctest\4_195.mfc
wav\isolated_digits_ti_test_endpt\WOMAN\MJ\5A_endpt.wav	mfctest\5_194.mfc
wav\isolated_digits_ti_test_endpt\WOMAN\MJ\5B_endpt.wav	mfctest\5_195.mfc
wav\isolated_digits_ti_test_endpt\WOMAN\MJ\6A_endpt.wav	mfctest\6_194.mfc
wav\isolated_digits_ti_test_endpt\WOMAN\MJ\6B_endpt.wav	mfctest\6_195.mfc
wav\isolated_digits_ti_test_endpt\WOMAN\MJ\7A_endpt.wav	mfctest\7_194.mfc
wav\isolated_digits_ti_test_endpt\WOMAN\MJ\7B_endpt.wav	mfctest\7_195.mfc
wav\isolated_digits_ti_test_endpt\WOMAN\MJ\8A_endpt.wav	mfctest\8_194.mfc
wav\isolated_digits_ti_test_endpt\WOMAN\MJ\8B_endpt.wav	mfctest\8_195.mfc
wav\isolated_digits_ti_test_endpt\WOMAN\MJ\9A_endpt.wav	mfctest\9_194.mfc
wav\isolated_digits_ti_test_endpt\WOMAN\MJ\9B_endpt.wav	mfctest\9_195.mfc
wav\isolated_digits_ti_test_endpt\WOMAN\MJ\OA_endpt.wav	mfctest\10_194.mfc
wav\isolated_digits_ti_test_endpt\WOMAN\MJ\OB_endpt.wav	mfctest\10_195.mfc
wav\isolated_digits_ti_test_endpt\WOMAN\MJ\ZA_endpt.wav	mfctest\0_194.mfc
wav\isolated_digits_ti_test_endpt\WOMAN\MJ\ZB_endpt.wav	mfctest\0_195.mfc
wav\isolated_digits_ti_test_endpt\WOMAN\ML\1A_endpt.wav	mfctest\1_196.mfc
wav\isolated_digits_ti_test_endpt\WOMAN\ML\1B_endpt.wav	mfctest\1_197.mfc
wav\isolated_digits_ti_test_endpt\WOMAN\ML\2A_endpt.wav	mfctest\2_196.mfc
wav\isolated_digits_ti_test_endpt\WOMAN\ML\2B_endpt.wav	mfctest\2_197.mfc
wav\isolated_digits_ti_test_endpt\WOMAN\ML\3A_endpt.wav	mfctest\3_196.mfc
wav\isolated_digits_ti_test_endpt\WOMAN\ML\3B_endpt.wav	mfctest\3_197.mfc
wav\isolated_digits_ti_test_endpt\WOMAN\ML\4A_endpt.wav	mfctest\4_196.mfc
wav\isolated_digits_ti_test_endpt\WOMAN\ML\4B_endpt.wav	mfctest\4_197.mfc
wav\isolated_digits_ti_test_endpt\WOMAN\ML\5A_endpt.wav	mfctest\5_196.mfc
wav\isolated_digits_ti_test_endpt\WOMAN\ML\5B_endpt.wav	mfctest\5_197.mfc
wav\isolated_digits_ti_test_endpt\WOMAN\ML\6A_endpt.wav	mfctest\6_196.mfc
wav\isolated_digits_ti_test_endpt\WOMAN\ML\6B_endpt.wav	mfctest\6_197.mfc
wav\isolated_digits_ti_test_endpt\WOMAN\ML\7A_endpt.wav	mfctest\7_196.mfc
wav\isolated_digits_ti_test_endpt\WOMAN\ML\7B_endpt.wav	mfctest\7_197.mfc
wav\isolated_digits_ti_test_endpt\WOMAN\ML\8A_endpt.wav	mfctest\8_196.mfc
wav\isolated_digits_ti_test_endpt\WOMAN\ML\8B_endpt.wav	mfctest\8_197.mfc
wav\isolated_digits_ti_test_endpt\WOMAN\ML\9A_endpt.wav	mfctest\9_196.mfc
wav\isolated_digits_ti_test_endpt\WOMAN\ML\9B_endpt.wav	mfctest\9_197.mfc
wav\isolated_digits_ti_test_endpt\WOMAN\ML\OA_endpt.wav	mfctest\10_196.mfc
wav\isolated_digits_ti_test_endpt\WOMAN\ML\OB_endpt.wav	mfctest\10_197.mfc
wav\isolated_digits_ti_test_endpt\WOMAN\ML\ZA_endpt.wav	mfctest\0_196.mfc
wav\isolated_digits_ti_test_endpt\WOMAN\ML\ZB_endpt.wav	mfctest\0_197.mfc
wav\isolated_digits_ti_test_endpt\WOMAN\NA\1A_endpt.wav	mfctest\1_198.mfc
wav\isolated_digits_ti_test_endpt\WOMAN\NA\1B_endpt.wav	mfctest\1_199.mfc
wav\isolated_digits_ti_test_endpt\WOMAN\NA\2A_endpt.wav	mfctest\2_198.mfc
wav\isolated_digits_ti_test_endpt\WOMAN\NA\2B_endpt.wav	mfctest\2_199.mfc
wav\isolated_digits_ti_test_endpt\WOMAN\NA\3A_endpt.wav	mfctest\3_198.mfc
wav\isolated_digits_ti_test_endpt\WOMAN\NA\3B_endpt.wav	mfctest\3_199.mfc
wav\isolated_digits_ti_test_endpt\WOMAN\NA\4A_endpt.wav	mfctest\4_198.mfc
wav\isolated_digits_ti_test_endpt\WOMAN\NA\4B_endpt.wav	mfctest\4_199.mfc
wav\isolated_digits_ti_test_endpt\WOMAN\NA\5A_endpt.wav	mfctest\5_198.mfc
wav\isolated_digits_ti_test_endpt\WOMAN\NA\5B_endpt.wav	mfctest\5_199.mfc
wav\isolated_digits_ti_test_endpt\WOMAN\NA\6A_endpt.wav	mfctest\6_198.mfc
wav\isolated_digits_ti_test_endpt\WOMAN\NA\6B_endpt.wav	mfctest\6_199.mfc
wav\isolated_digits_ti_test_endpt\WOMAN\NA\7A_endpt.wav	mfctest\7_198.mfc
wav\isolated_digits_ti_test_endpt\WOMAN\NA\7B_endpt.wav	mfctest\7_199.mfc
wav\isolated_digits_ti_test_endpt\WOMAN\NA\8A_endpt.wav	mfctest\8_198.mfc
wav\isolated_digits_ti_test_endpt\WOMAN\NA\8B_endpt.wav	mfctest\8_199.mfc
wav\isolated_digits_ti_test_endpt\WOMAN\NA\9A_endpt.wav	mfctest\9_198.mfc
wav\isolated_digits_ti_test_endpt\WOMAN\NA\9B_endpt.wav	mfctest\9_199.mfc
wav\isolated_digits_ti_test_endpt\WOMAN\NA\OA_endpt.wav	mfctest\10_198.mfc
wav\isolated_digits_ti_test_endpt\WOMAN\NA\OB_endpt.wav	mfctest\10_199.mfc
wav\isolated_digits_ti_test_endpt\WOMAN\NA\ZA_endpt.wav	mfctest\0_198.mfc
wav\isolated_digits_ti_test_endpt\WOMAN\NA\ZB_endpt.wav	mfctest\0_199.mfc
wav\isolated_digits_ti_test_endpt\WOMAN\NK\1A_endpt.wav	mfctest\1_200.mfc
wav\isolated_digits_ti_test_endpt\WOMAN\NK\1B_endpt.wav	mfctest\1_201.mfc
wav\isolated_digits_ti_test_endpt\WOMAN\NK\2A_endpt.wav	mfctest\2_200.mfc
wav\isolated_digits_ti_test_endpt\WOMAN\NK\2B_endpt.wav	mfctest\2_201.mfc
wav\isolated_digits_ti_test_endpt\WOMAN\NK\3A_endpt.wav	mfctest\3_200.mfc
wav\isolated_digits_ti_test_endpt\WOMAN\NK\3B_endpt.wav	mfctest\3_201.mfc
wav\isolated_digits_ti_test_endpt\WOMAN\NK\4A_endpt.wav	mfctest\4_200.mfc
wav\isolated_digits_ti_test_endpt\WOMAN\NK\4B_endpt.wav	mfctest\4_201.mfc
wav\isolated_digits_ti_test_endpt\WOMAN\NK\5A_endpt.wav	mfctest\5_200.mfc
wav\isolated_digits_ti_test_endpt\WOMAN\NK\5B_endpt.wav	mfctest\5_201.mfc
wav\isolated_digits_ti_test_endpt\WOMAN\NK\6A_endpt.wav	mfctest\6_200.mfc
wav\isolated_digits_ti_test_endpt\WOMAN\NK\6B_endpt.wav	mfctest\6_201.mfc
wav\isolated_digits_ti_test_endpt\WOMAN\NK\7A_endpt.wav	mfctest\7_200.mfc
wav\isolated_digits_ti_test_endpt\WOMAN\NK\7B_endpt.wav	mfctest\7_201.mfc
wav\isolated_digits_ti_test_endpt\WOMAN\NK\8A_endpt.wav	mfctest\8_200.mfc
wav\isolated_digits_ti_test_endpt\WOMAN\NK\8B_endpt.wav	mfctest\8_201.mfc
wav\isolated_digits_ti_test_endpt\WOMAN\NK\9A_endpt.wav	mfctest\9_200.mfc
wav\isolated_digits_ti_test_endpt\WOMAN\NK\9B_endpt.wav	mfctest\9_201.mfc
wav\isolated_digits_ti_test_endpt\WOMAN\NK\OA_endpt.wav	mfctest\10_200.mfc
wav\isolated_digits_ti_test_endpt\WOMAN\NK\OB_endpt.wav	mfctest\10_201.mfc
wav\isolated_digits_ti_test_endpt\WOMAN\NK\ZA_endpt.wav	mfctest\0_200.mfc
wav\isolated_digits_ti_test_endpt\WOMAN\NK\ZB_endpt.wav	mfctest\0_201.mfc
wav\isolated_digits_ti_test_endpt\WOMAN\PF\1A_endpt.wav	mfctest\1_202.mfc
wav\isolated_digits_ti_test_endpt\WOMAN\PF\1B_endpt.wav	mfctest\1_203.mfc
wav\isolated_digits_ti_test_endpt\WOMAN\PF\2A_endpt.wav	mfctest\2_202.mfc
wav\isolated_digits_ti_test_endpt\WOMAN\PF\2B_endpt.wav	mfctest\2_203.mfc
wav\isolated_digits_ti_test_endpt\WOMAN\PF\3A_endpt.wav	mfctest\3_202.mfc
wav\isolated_digits_ti_test_endpt\WOMAN\PF\3B_endpt.wav	mfctest\3_203.mfc
wav\isolated_digits_ti_test_endpt\WOMAN\PF\4A_endpt.wav	mfctest\4_202.mfc
wav\isolated_digits_ti_test_endpt\WOMAN\PF\4B_endpt.wav	mfctest\4_203.mfc
wav\isolated_digits_ti_test_endpt\WOMAN\PF\5A_endpt.wav	mfctest\5_202.mfc
wav\isolated_digits_ti_test_endpt\WOMAN\PF\5B_endpt.wav	mfctest\5_203.mfc
wav\isolated_digits_ti_test_endpt\WOMAN\PF\6A_endpt.wav	mfctest\6_202.mfc
wav\isolated_digits_ti_test_endpt\WOMAN\PF\6B_endpt.wav	mfctest\6_203.mfc
wav\isolated_digits_ti_test_endpt\WOMAN\PF\7A_endpt.wav	mfctest\7_202.mfc
wav\isolated_digits_ti_test_endpt\WOMAN\PF\7B_endpt.wav	mfctest\7_203.mfc
wav\isolated_digits_ti_test_endpt\WOMAN\PF\8A_endpt.wav	mfctest\8_202.mfc
wav\isolated_digits_ti_test_endpt\WOMAN\PF\8B_endpt.wav	mfctest\8_203.mfc
wav\isolated_digits_ti_test_endpt\WOMAN\PF\9A_endpt.wav	mfctest\9_202.mfc
wav\isolated_digits_ti_test_endpt\WOMAN\PF\9B_endpt.wav	mfctest\9_203.mfc
wav\isolated_digits_ti_test_endpt\WOMAN\PF\OA_endpt.wav	mfctest\10_202.mfc
wav\isolated_digits_ti_test_endpt\WOMAN\PF\OB_endpt.wav	mfctest\10_203.mfc
wav\isolated_digits_ti_test_endpt\WOMAN\PF\ZA_endpt.wav	mfctest\0_202.mfc
wav\isolated_digits_ti_test_endpt\WOMAN\PF\ZB_endpt.wav	mfctest\0_203.mfc
wav\isolated_digits_ti_test_endpt\WOMAN\PJ\1A_endpt.wav	mfctest\1_204.mfc
wav\isolated_digits_ti_test_endpt\WOMAN\PJ\1B_endpt.wav	mfctest\1_205.mfc
wav\isolated_digits_ti_test_endpt\WOMAN\PJ\2A_endpt.wav	mfctest\2_204.mfc
wav\isolated_digits_ti_test_endpt\WOMAN\PJ\2B_endpt.wav	mfctest\2_205.mfc
wav\isolated_digits_ti_test_endpt\WOMAN\PJ\3A_endpt.wav	mfctest\3_204.mfc
wav\isolated_digits_ti_test_endpt\WOMAN\PJ\3B_endpt.wav	mfctest\3_205.mfc
wav\isolated_digits_ti_test_endpt\WOMAN\PJ\4A_endpt.wav	mfctest\4_204.mfc
wav\isolated_digits_ti_test_endpt\WOMAN\PJ\4B_endpt.wav	mfctest\4_205.mfc
wav\isolated_digits_ti_test_endpt\WOMAN\PJ\5A_endpt.wav	mfctest\5_204.mfc
wav\isolated_digits_ti_test_endpt\WOMAN\PJ\5B_endpt.wav	mfctest\5_205.mfc
wav\isolated_digits_ti_test_endpt\WOMAN\PJ\6A_endpt.wav	mfctest\6_204.mfc
wav\isolated_digits_ti_test_endpt\WOMAN\PJ\6B_endpt.wav	mfctest\6_205.mfc
wav\isolated_digits_ti_test_endpt\WOMAN\PJ\7A_endpt.wav	mfctest\7_204.mfc
wav\isolated_digits_ti_test_endpt\WOMAN\PJ\7B_endpt.wav	mfctest\7_205.mfc
wav\isolated_digits_ti_test_endpt\WOMAN\PJ\8A_endpt.wav	mfctest\8_204.mfc
wav\isolated_digits_ti_test_endpt\WOMAN\PJ\8B_endpt.wav	mfctest\8_205.mfc
wav\isolated_digits_ti_test_endpt\WOMAN\PJ\9A_endpt.wav	mfctest\9_204.mfc
wav\isolated_digits_ti_test_endpt\WOMAN\PJ\9B_endpt.wav	mfctest\9_205.mfc
wav\isolated_digits_ti_test_endpt\WOMAN\PJ\OA_endpt.wav	mfctest\10_204.mfc
wav\isolated_digits_ti_test_endpt\WOMAN\PJ\OB_endpt.wav	mfctest\10_205.mfc
wav\isolated_digits_ti_test_endpt\WOMAN\PJ\ZA_endpt.wav	mfctest\0_204.mfc
wav\isolated_digits_ti_test_endpt\WOMAN\PJ\ZB_endpt.wav	mfctest\0_205.mfc
wav\isolated_digits_ti_test_endpt\WOMAN\PL\1A_endpt.wav	mfctest\1_206.mfc
wav\isolated_digits_ti_test_endpt\WOMAN\PL\1B_endpt.wav	mfctest\1_207.mfc
wav\isolated_digits_ti_test_endpt\WOMAN\PL\2A_endpt.wav	mfctest\2_206.mfc
wav\isolated_digits_ti_test_endpt\WOMAN\PL\2B_endpt.wav	mfctest\2_207.mfc
wav\isolated_digits_ti_test_endpt\WOMAN\PL\3A_endpt.wav	mfctest\3_206.mfc
wav\isolated_digits_ti_test_endpt\WOMAN\PL\3B_endpt.wav	mfctest\3_207.mfc
wav\isolated_digits_ti_test_endpt\WOMAN\PL\4A_endpt.wav	mfctest\4_206.mfc
wav\isolated_digits_ti_test_endpt\WOMAN\PL\4B_endpt.wav	mfctest\4_207.mfc
wav\isolated_digits_ti_test_endpt\WOMAN\PL\5A_endpt.wav	mfctest\5_206.mfc
wav\isolated_digits_ti_test_endpt\WOMAN\PL\5B_endpt.wav	mfctest\5_207.mfc
wav\isolated_digits_ti_test_endpt\WOMAN\PL\6A_endpt.wav	mfctest\6_206.mfc
wav\isolated_digits_ti_test_endpt\WOMAN\PL\6B_endpt.wav	mfctest\6_207.mfc
wav\isolated_digits_ti_test_endpt\WOMAN\PL\7A_endpt.wav	mfctest\7_206.mfc
wav\isolated_digits_ti_test_endpt\WOMAN\PL\7B_endpt.wav	mfctest\7_207.mfc
wav\isolated_digits_ti_test_endpt\WOMAN\PL\8A_endpt.wav	mfctest\8_206.mfc
wav\isolated_digits_ti_test_endpt\WOMAN\PL\8B_endpt.wav	mfctest\8_207.mfc
wav\isolated_digits_ti_test_endpt\WOMAN\PL\9A_endpt.wav	mfctest\9_206.mfc
wav\isolated_digits_ti_test_endpt\WOMAN\PL\9B_endpt.wav	mfctest\9_207.mfc
wav\isolated_digits_ti_test_endpt\WOMAN\PL\OA_endpt.wav	mfctest\10_206.mfc
wav\isolated_digits_ti_test_endpt\WOMAN\PL\OB_endpt.wav	mfctest\10_207.mfc
wav\isolated_digits_ti_test_endpt\WOMAN\PL\ZA_endpt.wav	mfctest\0_206.mfc
wav\isolated_digits_ti_test_endpt\WOMAN\PL\ZB_endpt.wav	mfctest\0_207.mfc
wav\isolated_digits_ti_test_endpt\WOMAN\PN\1A_endpt.wav	mfctest\1_208.mfc
wav\isolated_digits_ti_test_endpt\WOMAN\PN\1B_endpt.wav	mfctest\1_209.mfc
wav\isolated_digits_ti_test_endpt\WOMAN\PN\2A_endpt.wav	mfctest\2_208.mfc
wav\isolated_digits_ti_test_endpt\WOMAN\PN\2B_endpt.wav	mfctest\2_209.mfc
wav\isolated_digits_ti_test_endpt\WOMAN\PN\3A_endpt.wav	mfctest\3_208.mfc
wav\isolated_digits_ti_test_endpt\WOMAN\PN\3B_endpt.wav	mfctest\3_209.mfc
wav\isolated_digits_ti_test_endpt\WOMAN\PN\4A_endpt.wav	mfctest\4_208.mfc
wav\isolated_digits_ti_test_endpt\WOMAN\PN\4B_endpt.wav	mfctest\4_209.mfc
wav\isolated_digits_ti_test_endpt\WOMAN\PN\5A_endpt.wav	mfctest\5_208.mfc
wav\isolated_digits_ti_test_endpt\WOMAN\PN\5B_endpt.wav	mfctest\5_209.mfc
wav\isolated_digits_ti_test_endpt\WOMAN\PN\6A_endpt.wav	mfctest\6_208.mfc
wav\isolated_digits_ti_test_endpt\WOMAN\PN\6B_endpt.wav	mfctest\6_209.mfc
wav\isolated_digits_ti_test_endpt\WOMAN\PN\7A_endpt.wav	mfctest\7_208.mfc
wav\isolated_digits_ti_test_endpt\WOMAN\PN\7B_endpt.wav	mfctest\7_209.mfc
wav\isolated_digits_ti_test_endpt\WOMAN\PN\8A_endpt.wav	mfctest\8_208.mfc
wav\isolated_digits_ti_test_endpt\WOMAN\PN\8B_endpt.wav	mfctest\8_209.mfc
wav\isolated_digits_ti_test_endpt\WOMAN\PN\9A_endpt.wav	mfctest\9_208.mfc
wav\isolated_digits_ti_test_endpt\WOMAN\PN\9B_endpt.wav	mfctest\9_209.mfc
wav\isolated_digits_ti_test_endpt\WOMAN\PN\OA_endpt.wav	mfctest\10_208.mfc
wav\isolated_digits_ti_test_endpt\WOMAN\PN\OB_endpt.wav	mfctest\10_209.mfc
wav\isolated_digits_ti_test_endpt\WOMAN\PN\ZA_endpt.wav	mfctest\0_208.mfc
wav\isolated_digits_ti_test_endpt\WOMAN\PN\ZB_endpt.wav	mfctest\0_209.mfc
wav\isolated_digits_ti_test_endpt\WOMAN\PT\1A_endpt.wav	mfctest\1_210.mfc
wav\isolated_digits_ti_test_endpt\WOMAN\PT\1B_endpt.wav	mfctest\1_211.mfc
wav\isolated_digits_ti_test_endpt\WOMAN\PT\2A_endpt.wav	mfctest\2_210.mfc
wav\isolated_digits_ti_test_endpt\WOMAN\PT\2B_endpt.wav	mfctest\2_211.mfc
wav\isolated_digits_ti_test_endpt\WOMAN\PT\3A_endpt.wav	mfctest\3_210.mfc
wav\isolated_digits_ti_test_endpt\WOMAN\PT\3B_endpt.wav	mfctest\3_211.mfc
wav\isolated_digits_ti_test_endpt\WOMAN\PT\4A_endpt.wav	mfctest\4_210.mfc
wav\isolated_digits_ti_test_endpt\WOMAN\PT\4B_endpt.wav	mfctest\4_211.mfc
wav\isolated_digits_ti_test_endpt\WOMAN\PT\5A_endpt.wav	mfctest\5_210.mfc
wav\isolated_digits_ti_test_endpt\WOMAN\PT\5B_endpt.wav	mfctest\5_211.mfc
wav\isolated_digits_ti_test_endpt\WOMAN\PT\6A_endpt.wav	mfctest\6_210.mfc
wav\isolated_digits_ti_test_endpt\WOMAN\PT\6B_endpt.wav	mfctest\6_211.mfc
wav\isolated_digits_ti_test_endpt\WOMAN\PT\7A_endpt.wav	mfctest\7_210.mfc
wav\isolated_digits_ti_test_endpt\WOMAN\PT\7B_endpt.wav	mfctest\7_211.mfc
wav\isolated_digits_ti_test_endpt\WOMAN\PT\8A_endpt.wav	mfctest\8_210.mfc
wav\isolated_digits_ti_test_endpt\WOMAN\PT\8B_endpt.wav	mfctest\8_211.mfc
wav\isolated_digits_ti_test_endpt\WOMAN\PT\9A_endpt.wav	mfctest\9_210.mfc
wav\isolated_digits_ti_test_endpt\WOMAN\PT\9B_endpt.wav	mfctest\9_211.mfc
wav\isolated_digits_ti_test_endpt\WOMAN\PT\OA_endpt.wav	mfctest\10_210.mfc
wav\isolated_digits_ti_test_endpt\WOMAN\PT\OB_endpt.wav	mfctest\10_211.mfc
wav\isolated_digits_ti_test_endpt\WOMAN\PT\ZA_endpt.wav	mfctest\0_210.mfc
wav\isolated_digits_ti_test_endpt\WOMAN\PT\ZB_endpt.wav	mfctest\0_211.mfc
wav\isolated_digits_ti_test_endpt\WOMAN\RG\1A_endpt.wav	mfctest\1_212.mfc
wav\isolated_digits_ti_test_endpt\WOMAN\RG\1B_endpt.wav	mfctest\1_213.mfc
wav\isolated_digits_ti_test_endpt\WOMAN\RG\2A_endpt.wav	mfctest\2_212.mfc
wav\isolated_digits_ti_test_endpt\WOMAN\RG\2B_endpt.wav	mfctest\2_213.mfc
wav\isolated_digits_ti_test_endpt\WOMAN\RG\3A_endpt.wav	mfctest\3_212.mfc
wav\isolated_digits_ti_test_endpt\WOMAN\RG\3B_endpt.wav	mfctest\3_213.mfc
wav\isolated_digits_ti_test_endpt\WOMAN\RG\4A_endpt.wav	mfctest\4_212.mfc
wav\isolated_digits_ti_test_endpt\WOMAN\RG\4B_endpt.wav	mfctest\4_213.mfc
wav\isolated_digits_ti_test_endpt\WOMAN\RG\5A_endpt.wav	mfctest\5_212.mfc
wav\isolated_digits_ti_test_endpt\WOMAN\RG\5B_endpt.wav	mfctest\5_213.mfc
wav\isolated_digits_ti_test_endpt\WOMAN\RG\6A_endpt.wav	mfctest\6_212.mfc
wav\isolated_digits_ti_test_endpt\WOMAN\RG\6B_endpt.wav	mfctest\6_213.mfc
wav\isolated_digits_ti_test_endpt\WOMAN\RG\7A_endpt.wav	mfctest\7_212.mfc
wav\isolated_digits_ti_test_endpt\WOMAN\RG\7B_endpt.wav	mfctest\7_213.mfc
wav\isolated_digits_ti_test_endpt\WOMAN\RG\8A_endpt.wav	mfctest\8_212.mfc
wav\isolated_digits_ti_test_endpt\WOMAN\RG\8B_endpt.wav	mfctest\8_213.mfc
wav\isolated_digits_ti_test_endpt\WOMAN\RG\9A_endpt.wav	mfctest\9_212.mfc
wav\isolated_digits_ti_test_endpt\WOMAN\RG\9B_endpt.wav	mfctest\9_213.mfc
wav\isolated_digits_ti_test_endpt\WOMAN\RG\OA_endpt.wav	mfctest\10_212.mfc
wav\isolated_digits_ti_test_endpt\WOMAN\RG\OB_endpt.wav	mfctest\10_213.mfc
wav\isolated_digits_ti_test_endpt\WOMAN\RG\ZA_endpt.wav	mfctest\0_212.mfc
wav\isolated_digits_ti_test_endpt\WOMAN\RG\ZB_endpt.wav	mfctest\0_213.mfc
wav\isolated_digits_ti_test_endpt\WOMAN\RL\1A_endpt.wav	mfctest\1_214.mfc
wav\isolated_digits_ti_test_endpt\WOMAN\RL\1B_endpt.wav	mfctest\1_215.mfc
wav\isolated_digits_ti_test_endpt\WOMAN\RL\2A_endpt.wav	mfctest\2_214.mfc
wav\isolated_digits_ti_test_endpt\WOMAN\RL\2B_endpt.wav	mfctest\2_215.mfc
wav\isolated_digits_ti_test_endpt\WOMAN\RL\3A_endpt.wav	mfctest\3_214.mfc
wav\isolated_digits_ti_test_endpt\WOMAN\RL\3B_endpt.wav	mfctest\3_215.mfc
wav\isolated_digits_ti_test_endpt\WOMAN\RL\4A_endpt.wav	mfctest\4_214.mfc
wav\isolated_digits_ti_test_endpt\WOMAN\RL\4B_endpt.wav	mfctest\4_215.mfc
wav\isolated_digits_ti_test_endpt\WOMAN\RL\5A_endpt.wav	mfctest\5_214.mfc
wav\isolated_digits_ti_test_endpt\WOMAN\RL\5B_endpt.wav	mfctest\5_215.mfc
wav\isolated_digits_ti_test_endpt\WOMAN\RL\6A_endpt.wav	mfctest\6_214.mfc
wav\isolated_digits_ti_test_endpt\WOMAN\RL\6B_endpt.wav	mfctest\6_215.mfc
wav\isolated_digits_ti_test_endpt\WOMAN\RL\7A_endpt.wav	mfctest\7_214.mfc
wav\isolated_digits_ti_test_endpt\WOMAN\RL\7B_endpt.wav	mfctest\7_215.mfc
wav\isolated_digits_ti_test_endpt\WOMAN\RL\8A_endpt.wav	mfctest\8_214.mfc
wav\isolated_digits_ti_test_endpt\WOMAN\RL\8B_endpt.wav	mfctest\8_215.mfc
wav\isolated_digits_ti_test_endpt\WOMAN\RL\9A_endpt.wav	mfctest\9_214.mfc
wav\isolated_digits_ti_test_endpt\WOMAN\RL\9B_endpt.wav	mfctest\9_215.mfc
wav\isolated_digits_ti_test_endpt\WOMAN\RL\OA_endpt.wav	mfctest\10_214.mfc
wav\isolated_digits_ti_test_endpt\WOMAN\RL\OB_endpt.wav	mfctest\10_215.mfc
wav\isolated_digits_ti_test_endpt\WOMAN\RL\ZA_endpt.wav	mfctest\0_214.mfc
wav\isolated_digits_ti_test_endpt\WOMAN\RL\ZB_endpt.wav	mfctest\0_215.mfc
wav\isolated_digits_ti_test_endpt\WOMAN\RM\1A_endpt.wav	mfctest\1_216.mfc
wav\isolated_digits_ti_test_endpt\WOMAN\RM\1B_endpt.wav	mfctest\1_217.mfc
wav\isolated_digits_ti_test_endpt\WOMAN\RM\2A_endpt.wav	mfctest\2_216.mfc
wav\isolated_digits_ti_test_endpt\WOMAN\RM\2B_endpt.wav	mfctest\2_217.mfc
wav\isolated_digits_ti_test_endpt\WOMAN\RM\3A_endpt.wav	mfctest\3_216.mfc
wav\isolated_digits_ti_test_endpt\WOMAN\RM\3B_endpt.wav	mfctest\3_217.mfc
wav\isolated_digits_ti_test_endpt\WOMAN\RM\4A_endpt.wav	mfctest\4_216.mfc
wav\isolated_digits_ti_test_endpt\WOMAN\RM\4B_endpt.wav	mfctest\4_217.mfc
wav\isolated_digits_ti_test_endpt\WOMAN\RM\5A_endpt.wav	mfctest\5_216.mfc
wav\isolated_digits_ti_test_endpt\WOMAN\RM\5B_endpt.wav	mfctest\5_217.mfc
wav\isolated_digits_ti_test_endpt\WOMAN\RM\6A_endpt.wav	mfctest\6_216.mfc
wav\isolated_digits_ti_test_endpt\WOMAN\RM\6B_endpt.wav	mfctest\6_217.mfc
wav\isolated_digits_ti_test_endpt\WOMAN\RM\7A_endpt.wav	mfctest\7_216.mfc
wav\isolated_digits_ti_test_endpt\WOMAN\RM\7B_endpt.wav	mfctest\7_217.mfc
wav\isolated_digits_ti_test_endpt\WOMAN\RM\8A_endpt.wav	mfctest\8_216.mfc
wav\isolated_digits_ti_test_endpt\WOMAN\RM\8B_endpt.wav	mfctest\8_217.mfc
wav\isolated_digits_ti_test_endpt\WOMAN\RM\9A_endpt.wav	mfctest\9_216.mfc
wav\isolated_digits_ti_test_endpt\WOMAN\RM\9B_endpt.wav	mfctest\9_217.mfc
wav\isolated_digits_ti_test_endpt\WOMAN\RM\OA_endpt.wav	mfctest\10_216.mfc
wav\isolated_digits_ti_test_endpt\WOMAN\RM\OB_endpt.wav	mfctest\10_217.mfc
wav\isolated_digits_ti_test_endpt\WOMAN\RM\ZA_endpt.wav	mfctest\0_216.mfc
wav\isolated_digits_ti_test_endpt\WOMAN\RM\ZB_endpt.wav	mfctest\0_217.mfc
wav\isolated_digits_ti_test_endpt\WOMAN\SI\1A_endpt.wav	mfctest\1_218.mfc
wav\isolated_digits_ti_test_endpt\WOMAN\SI\1B_endpt.wav	mfctest\1_219.mfc
wav\isolated_digits_ti_test_endpt\WOMAN\SI\2A_endpt.wav	mfctest\2_218.mfc
wav\isolated_digits_ti_test_endpt\WOMAN\SI\2B_endpt.wav	mfctest\2_219.mfc
wav\isolated_digits_ti_test_endpt\WOMAN\SI\3A_endpt.wav	mfctest\3_218.mfc
wav\isolated_digits_ti_test_endpt\WOMAN\SI\3B_endpt.wav	mfctest\3_219.mfc
wav\isolated_digits_ti_test_endpt\WOMAN\SI\4A_endpt.wav	mfctest\4_218.mfc
wav\isolated_digits_ti_test_endpt\WOMAN\SI\4B_endpt.wav	mfctest\4_219.mfc
wav\isolated_digits_ti_test_endpt\WOMAN\SI\5A_endpt.wav	mfctest\5_218.mfc
wav\isolated_digits_ti_test_endpt\WOMAN\SI\5B_endpt.wav	mfctest\5_219.mfc
wav\isolated_digits_ti_test_endpt\WOMAN\SI\6A_endpt.wav	mfctest\6_218.mfc
wav\isolated_digits_ti_test_endpt\WOMAN\SI\6B_endpt.wav	mfctest\6_219.mfc
wav\isolated_digits_ti_test_endpt\WOMAN\SI\7A_endpt.wav	mfctest\7_218.mfc
wav\isolated_digits_ti_test_endpt\WOMAN\SI\7B_endpt.wav	mfctest\7_219.mfc
wav\isolated_digits_ti_test_endpt\WOMAN\SI\8A_endpt.wav	mfctest\8_218.mfc
wav\isolated_digits_ti_test_endpt\WOMAN\SI\8B_endpt.wav	mfctest\8_219.mfc
wav\isolated_digits_ti_test_endpt\WOMAN\SI\9A_endpt.wav	mfctest\9_218.mfc
wav\isolated_digits_ti_test_endpt\WOMAN\SI\9B_endpt.wav	mfctest\9_219.mfc
wav\isolated_digits_ti_test_endpt\WOMAN\SI\OA_endpt.wav	mfctest\10_218.mfc
wav\isolated_digits_ti_test_endpt\WOMAN\SI\OB_endpt.wav	mfctest\10_219.mfc
wav\isolated_digits_ti_test_endpt\WOMAN\SI\ZA_endpt.wav	mfctest\0_218.mfc
wav\isolated_digits_ti_test_endpt\WOMAN\SI\ZB_endpt.wav	mfctest\0_219.mfc
wav\isolated_digits_ti_test_endpt\WOMAN\SM\1A_endpt.wav	mfctest\1_220.mfc
wav\isolated_digits_ti_test_endpt\WOMAN\SM\1B_endpt.wav	mfctest\1_221.mfc
wav\isolated_digits_ti_test_endpt\WOMAN\SM\2A_endpt.wav	mfctest\2_220.mfc
wav\isolated_digits_ti_test_endpt\WOMAN\SM\2B_endpt.wav	mfctest\2_221.mfc
wav\isolated_digits_ti_test_endpt\WOMAN\SM\3A_endpt.wav	mfctest\3_220.mfc
wav\isolated_digits_ti_test_endpt\WOMAN\SM\3B_endpt.wav	mfctest\3_221.mfc
wav\isolated_digits_ti_test_endpt\WOMAN\SM\4A_endpt.wav	mfctest\4_220.mfc
wav\isolated_digits_ti_test_endpt\WOMAN\SM\4B_endpt.wav	mfctest\4_221.mfc
wav\isolated_digits_ti_test_endpt\WOMAN\SM\5A_endpt.wav	mfctest\5_220.mfc
wav\isolated_digits_ti_test_endpt\WOMAN\SM\5B_endpt.wav	mfctest\5_221.mfc
wav\isolated_digits_ti_test_endpt\WOMAN\SM\6A_endpt.wav	mfctest\6_220.mfc
wav\isolated_digits_ti_test_endpt\WOMAN\SM\6B_endpt.wav	mfctest\6_221.mfc
wav\isolated_digits_ti_test_endpt\WOMAN\SM\7A_endpt.wav	mfctest\7_220.mfc
wav\isolated_digits_ti_test_endpt\WOMAN\SM\7B_endpt.wav	mfctest\7_221.mfc
wav\isolated_digits_ti_test_endpt\WOMAN\SM\8A_endpt.wav	mfctest\8_220.mfc
wav\isolated_digits_ti_test_endpt\WOMAN\SM\8B_endpt.wav	mfctest\8_221.mfc
wav\isolated_digits_ti_test_endpt\WOMAN\SM\9A_endpt.wav	mfctest\9_220.mfc
wav\isolated_digits_ti_test_endpt\WOMAN\SM\9B_endpt.wav	mfctest\9_221.mfc
wav\isolated_digits_ti_test_endpt\WOMAN\SM\OA_endpt.wav	mfctest\10_220.mfc
wav\isolated_digits_ti_test_endpt\WOMAN\SM\OB_endpt.wav	mfctest\10_221.mfc
wav\isolated_digits_ti_test_endpt\WOMAN\SM\ZA_endpt.wav	mfctest\0_220.mfc
wav\isolated_digits_ti_test_endpt\WOMAN\SM\ZB_endpt.wav	mfctest\0_221.mfc
wav\isolated_digits_ti_test_endpt\WOMAN\SN\1A_endpt.wav	mfctest\1_222.mfc
wav\isolated_digits_ti_test_endpt\WOMAN\SN\1B_endpt.wav	mfctest\1_223.mfc
wav\isolated_digits_ti_test_endpt\WOMAN\SN\2A_endpt.wav	mfctest\2_222.mfc
wav\isolated_digits_ti_test_endpt\WOMAN\SN\2B_endpt.wav	mfctest\2_223.mfc
wav\isolated_digits_ti_test_endpt\WOMAN\SN\3A_endpt.wav	mfctest\3_222.mfc
wav\isolated_digits_ti_test_endpt\WOMAN\SN\3B_endpt.wav	mfctest\3_223.mfc
wav\isolated_digits_ti_test_endpt\WOMAN\SN\4A_endpt.wav	mfctest\4_222.mfc
wav\isolated_digits_ti_test_endpt\WOMAN\SN\4B_endpt.wav	mfctest\4_223.mfc
wav\isolated_digits_ti_test_endpt\WOMAN\SN\5A_endpt.wav	mfctest\5_222.mfc
wav\isolated_digits_ti_test_endpt\WOMAN\SN\5B_endpt.wav	mfctest\5_223.mfc
wav\isolated_digits_ti_test_endpt\WOMAN\SN\6A_endpt.wav	mfctest\6_222.mfc
wav\isolated_digits_ti_test_endpt\WOMAN\SN\6B_endpt.wav	mfctest\6_223.mfc
wav\isolated_digits_ti_test_endpt\WOMAN\SN\7A_endpt.wav	mfctest\7_222.mfc
wav\isolated_digits_ti_test_endpt\WOMAN\SN\7B_endpt.wav	mfctest\7_223.mfc
wav\isolated_digits_ti_test_endpt\WOMAN\SN\8A_endpt.wav	mfctest\8_222.mfc
wav\isolated_digits_ti_test_endpt\WOMAN\SN\8B_endpt.wav	mfctest\8_223.mfc
wav\isolated_digits_ti_test_endpt\WOMAN\SN\9A_endpt.wav	mfctest\9_222.mfc
wav\isolated_digits_ti_test_endpt\WOMAN\SN\9B_endpt.wav	mfctest\9_223.mfc
wav\isolated_digits_ti_test_endpt\WOMAN\SN\OA_endpt.wav	mfctest\10_222.mfc
wav\isolated_digits_ti_test_endpt\WOMAN\SN\OB_endpt.wav	mfctest\10_223.mfc
wav\isolated_digits_ti_test_endpt\WOMAN\SN\ZA_endpt.wav	mfctest\0_222.mfc
wav\isolated_digits_ti_test_endpt\WOMAN\SN\ZB_endpt.wav	mfctest\0_223.mfc
wav\isolated_digits_ti_test_endpt\WOMAN\TB\1A_endpt.wav	mfctest\1_224.mfc
wav\isolated_digits_ti_test_endpt\WOMAN\TB\1B_endpt.wav	mfctest\1_225.mfc
wav\isolated_digits_ti_test_endpt\WOMAN\TB\2A_endpt.wav	mfctest\2_224.mfc
wav\isolated_digits_ti_test_endpt\WOMAN\TB\2B_endpt.wav	mfctest\2_225.mfc
wav\isolated_digits_ti_test_endpt\WOMAN\TB\3A_endpt.wav	mfctest\3_224.mfc
wav\isolated_digits_ti_test_endpt\WOMAN\TB\3B_endpt.wav	mfctest\3_225.mfc
wav\isolated_digits_ti_test_endpt\WOMAN\TB\4A_endpt.wav	mfctest\4_224.mfc
wav\isolated_digits_ti_test_endpt\WOMAN\TB\4B_endpt.wav	mfctest\4_225.mfc
wav\isolated_digits_ti_test_endpt\WOMAN\TB\5A_endpt.wav	mfctest\5_224.mfc
wav\isolated_digits_ti_test_endpt\WOMAN\TB\5B_endpt.wav	mfctest\5_225.mfc
wav\isolated_digits_ti_test_endpt\WOMAN\TB\6A_endpt.wav	mfctest\6_224.mfc
wav\isolated_digits_ti_test_endpt\WOMAN\TB\6B_endpt.wav	mfctest\6_225.mfc
wav\isolated_digits_ti_test_endpt\WOMAN\TB\7A_endpt.wav	mfctest\7_224.mfc
wav\isolated_digits_ti_test_endpt\WOMAN\TB\7B_endpt.wav	mfctest\7_225.mfc
wav\isolated_digits_ti_test_endpt\WOMAN\TB\8A_endpt.wav	mfctest\8_224.mfc
wav\isolated_digits_ti_test_endpt\WOMAN\TB\8B_endpt.wav	mfctest\8_225.mfc
wav\isolated_digits_ti_test_endpt\WOMAN\TB\9A_endpt.wav	mfctest\9_224.mfc
wav\isolated_digits_ti_test_endpt\WOMAN\TB\9B_endpt.wav	mfctest\9_225.mfc
wav\isolated_digits_ti_test_endpt\WOMAN\TB\OA_endpt.wav	mfctest\10_224.mfc
wav\isolated_digits_ti_test_endpt\WOMAN\TB\OB_endpt.wav	mfctest\10_225.mfc
wav\isolated_digits_ti_test_endpt\WOMAN\TB\ZA_endpt.wav	mfctest\0_224.mfc
wav\isolated_digits_ti_test_endpt\WOMAN\TB\ZB_endpt.wav	mfctest\0_225.mfc
