wav\isolated_digits_ti_train_endpt\MAN\AE\1A_endpt.wav	mfctrain\1_0.mfc
wav\isolated_digits_ti_train_endpt\MAN\AE\1B_endpt.wav	mfctrain\1_1.mfc
wav\isolated_digits_ti_train_endpt\MAN\AE\2A_endpt.wav	mfctrain\2_0.mfc
wav\isolated_digits_ti_train_endpt\MAN\AE\2B_endpt.wav	mfctrain\2_1.mfc
wav\isolated_digits_ti_train_endpt\MAN\AE\3A_endpt.wav	mfctrain\3_0.mfc
wav\isolated_digits_ti_train_endpt\MAN\AE\3B_endpt.wav	mfctrain\3_1.mfc
wav\isolated_digits_ti_train_endpt\MAN\AE\4A_endpt.wav	mfctrain\4_0.mfc
wav\isolated_digits_ti_train_endpt\MAN\AE\4B_endpt.wav	mfctrain\4_1.mfc
wav\isolated_digits_ti_train_endpt\MAN\AE\5A_endpt.wav	mfctrain\5_0.mfc
wav\isolated_digits_ti_train_endpt\MAN\AE\5B_endpt.wav	mfctrain\5_1.mfc
wav\isolated_digits_ti_train_endpt\MAN\AE\6A_endpt.wav	mfctrain\6_0.mfc
wav\isolated_digits_ti_train_endpt\MAN\AE\6B_endpt.wav	mfctrain\6_1.mfc
wav\isolated_digits_ti_train_endpt\MAN\AE\7A_endpt.wav	mfctrain\7_0.mfc
wav\isolated_digits_ti_train_endpt\MAN\AE\7B_endpt.wav	mfctrain\7_1.mfc
wav\isolated_digits_ti_train_endpt\MAN\AE\8A_endpt.wav	mfctrain\8_0.mfc
wav\isolated_digits_ti_train_endpt\MAN\AE\8B_endpt.wav	mfctrain\8_1.mfc
wav\isolated_digits_ti_train_endpt\MAN\AE\9A_endpt.wav	mfctrain\9_0.mfc
wav\isolated_digits_ti_train_endpt\MAN\AE\9B_endpt.wav	mfctrain\9_1.mfc
wav\isolated_digits_ti_train_endpt\MAN\AE\OA_endpt.wav	mfctrain\10_0.mfc
wav\isolated_digits_ti_train_endpt\MAN\AE\OB_endpt.wav	mfctrain\10_1.mfc
wav\isolated_digits_ti_train_endpt\MAN\AE\ZA_endpt.wav	mfctrain\0_0.mfc
wav\isolated_digits_ti_train_endpt\MAN\AE\ZB_endpt.wav	mfctrain\0_1.mfc
wav\isolated_digits_ti_train_endpt\MAN\AJ\1A_endpt.wav	mfctrain\1_2.mfc
wav\isolated_digits_ti_train_endpt\MAN\AJ\1B_endpt.wav	mfctrain\1_3.mfc
wav\isolated_digits_ti_train_endpt\MAN\AJ\2A_endpt.wav	mfctrain\2_2.mfc
wav\isolated_digits_ti_train_endpt\MAN\AJ\2B_endpt.wav	mfctrain\2_3.mfc
wav\isolated_digits_ti_train_endpt\MAN\AJ\3A_endpt.wav	mfctrain\3_2.mfc
wav\isolated_digits_ti_train_endpt\MAN\AJ\3B_endpt.wav	mfctrain\3_3.mfc
wav\isolated_digits_ti_train_endpt\MAN\AJ\4A_endpt.wav	mfctrain\4_2.mfc
wav\isolated_digits_ti_train_endpt\MAN\AJ\4B_endpt.wav	mfctrain\4_3.mfc
wav\isolated_digits_ti_train_endpt\MAN\AJ\5A_endpt.wav	mfctrain\5_2.mfc
wav\isolated_digits_ti_train_endpt\MAN\AJ\5B_endpt.wav	mfctrain\5_3.mfc
wav\isolated_digits_ti_train_endpt\MAN\AJ\6A_endpt.wav	mfctrain\6_2.mfc
wav\isolated_digits_ti_train_endpt\MAN\AJ\6B_endpt.wav	mfctrain\6_3.mfc
wav\isolated_digits_ti_train_endpt\MAN\AJ\7A_endpt.wav	mfctrain\7_2.mfc
wav\isolated_digits_ti_train_endpt\MAN\AJ\7B_endpt.wav	mfctrain\7_3.mfc
wav\isolated_digits_ti_train_endpt\MAN\AJ\8A_endpt.wav	mfctrain\8_2.mfc
wav\isolated_digits_ti_train_endpt\MAN\AJ\8B_endpt.wav	mfctrain\8_3.mfc
wav\isolated_digits_ti_train_endpt\MAN\AJ\9A_endpt.wav	mfctrain\9_2.mfc
wav\isolated_digits_ti_train_endpt\MAN\AJ\9B_endpt.wav	mfctrain\9_3.mfc
wav\isolated_digits_ti_train_endpt\MAN\AJ\OA_endpt.wav	mfctrain\10_2.mfc
wav\isolated_digits_ti_train_endpt\MAN\AJ\OB_endpt.wav	mfctrain\10_3.mfc
wav\isolated_digits_ti_train_endpt\MAN\AJ\ZA_endpt.wav	mfctrain\0_2.mfc
wav\isolated_digits_ti_train_endpt\MAN\AJ\ZB_endpt.wav	mfctrain\0_3.mfc
wav\isolated_digits_ti_train_endpt\MAN\AL\1A_endpt.wav	mfctrain\1_4.mfc
wav\isolated_digits_ti_train_endpt\MAN\AL\1B_endpt.wav	mfctrain\1_5.mfc
wav\isolated_digits_ti_train_endpt\MAN\AL\2A_endpt.wav	mfctrain\2_4.mfc
wav\isolated_digits_ti_train_endpt\MAN\AL\2B_endpt.wav	mfctrain\2_5.mfc
wav\isolated_digits_ti_train_endpt\MAN\AL\3A_endpt.wav	mfctrain\3_4.mfc
wav\isolated_digits_ti_train_endpt\MAN\AL\3B_endpt.wav	mfctrain\3_5.mfc
wav\isolated_digits_ti_train_endpt\MAN\AL\4A_endpt.wav	mfctrain\4_4.mfc
wav\isolated_digits_ti_train_endpt\MAN\AL\4B_endpt.wav	mfctrain\4_5.mfc
wav\isolated_digits_ti_train_endpt\MAN\AL\5A_endpt.wav	mfctrain\5_4.mfc
wav\isolated_digits_ti_train_endpt\MAN\AL\5B_endpt.wav	mfctrain\5_5.mfc
wav\isolated_digits_ti_train_endpt\MAN\AL\6A_endpt.wav	mfctrain\6_4.mfc
wav\isolated_digits_ti_train_endpt\MAN\AL\6B_endpt.wav	mfctrain\6_5.mfc
wav\isolated_digits_ti_train_endpt\MAN\AL\7A_endpt.wav	mfctrain\7_4.mfc
wav\isolated_digits_ti_train_endpt\MAN\AL\7B_endpt.wav	mfctrain\7_5.mfc
wav\isolated_digits_ti_train_endpt\MAN\AL\8A_endpt.wav	mfctrain\8_4.mfc
wav\isolated_digits_ti_train_endpt\MAN\AL\8B_endpt.wav	mfctrain\8_5.mfc
wav\isolated_digits_ti_train_endpt\MAN\AL\9A_endpt.wav	mfctrain\9_4.mfc
wav\isolated_digits_ti_train_endpt\MAN\AL\9B_endpt.wav	mfctrain\9_5.mfc
wav\isolated_digits_ti_train_endpt\MAN\AL\OA_endpt.wav	mfctrain\10_4.mfc
wav\isolated_digits_ti_train_endpt\MAN\AL\OB_endpt.wav	mfctrain\10_5.mfc
wav\isolated_digits_ti_train_endpt\MAN\AL\ZA_endpt.wav	mfctrain\0_4.mfc
wav\isolated_digits_ti_train_endpt\MAN\AL\ZB_endpt.wav	mfctrain\0_5.mfc
wav\isolated_digits_ti_train_endpt\MAN\AW\1A_endpt.wav	mfctrain\1_6.mfc
wav\isolated_digits_ti_train_endpt\MAN\AW\1B_endpt.wav	mfctrain\1_7.mfc
wav\isolated_digits_ti_train_endpt\MAN\AW\2A_endpt.wav	mfctrain\2_6.mfc
wav\isolated_digits_ti_train_endpt\MAN\AW\2B_endpt.wav	mfctrain\2_7.mfc
wav\isolated_digits_ti_train_endpt\MAN\AW\3A_endpt.wav	mfctrain\3_6.mfc
wav\isolated_digits_ti_train_endpt\MAN\AW\3B_endpt.wav	mfctrain\3_7.mfc
wav\isolated_digits_ti_train_endpt\MAN\AW\4A_endpt.wav	mfctrain\4_6.mfc
wav\isolated_digits_ti_train_endpt\MAN\AW\4B_endpt.wav	mfctrain\4_7.mfc
wav\isolated_digits_ti_train_endpt\MAN\AW\5A_endpt.wav	mfctrain\5_6.mfc
wav\isolated_digits_ti_train_endpt\MAN\AW\5B_endpt.wav	mfctrain\5_7.mfc
wav\isolated_digits_ti_train_endpt\MAN\AW\6A_endpt.wav	mfctrain\6_6.mfc
wav\isolated_digits_ti_train_endpt\MAN\AW\6B_endpt.wav	mfctrain\6_7.mfc
wav\isolated_digits_ti_train_endpt\MAN\AW\7A_endpt.wav	mfctrain\7_6.mfc
wav\isolated_digits_ti_train_endpt\MAN\AW\7B_endpt.wav	mfctrain\7_7.mfc
wav\isolated_digits_ti_train_endpt\MAN\AW\8A_endpt.wav	mfctrain\8_6.mfc
wav\isolated_digits_ti_train_endpt\MAN\AW\8B_endpt.wav	mfctrain\8_7.mfc
wav\isolated_digits_ti_train_endpt\MAN\AW\9A_endpt.wav	mfctrain\9_6.mfc
wav\isolated_digits_ti_train_endpt\MAN\AW\9B_endpt.wav	mfctrain\9_7.mfc
wav\isolated_digits_ti_train_endpt\MAN\AW\OA_endpt.wav	mfctrain\10_6.mfc
wav\isolated_digits_ti_train_endpt\MAN\AW\OB_endpt.wav	mfctrain\10_7.mfc
wav\isolated_digits_ti_train_endpt\MAN\AW\ZA_endpt.wav	mfctrain\0_6.mfc
wav\isolated_digits_ti_train_endpt\MAN\AW\ZB_endpt.wav	mfctrain\0_7.mfc
wav\isolated_digits_ti_train_endpt\MAN\BD\1A_endpt.wav	mfctrain\1_8.mfc
wav\isolated_digits_ti_train_endpt\MAN\BD\1B_endpt.wav	mfctrain\1_9.mfc
wav\isolated_digits_ti_train_endpt\MAN\BD\2A_endpt.wav	mfctrain\2_8.mfc
wav\isolated_digits_ti_train_endpt\MAN\BD\2B_endpt.wav	mfctrain\2_9.mfc
wav\isolated_digits_ti_train_endpt\MAN\BD\3A_endpt.wav	mfctrain\3_8.mfc
wav\isolated_digits_ti_train_endpt\MAN\BD\3B_endpt.wav	mfctrain\3_9.mfc
wav\isolated_digits_ti_train_endpt\MAN\BD\4A_endpt.wav	mfctrain\4_8.mfc
wav\isolated_digits_ti_train_endpt\MAN\BD\4B_endpt.wav	mfctrain\4_9.mfc
wav\isolated_digits_ti_train_endpt\MAN\BD\5A_endpt.wav	mfctrain\5_8.mfc
wav\isolated_digits_ti_train_endpt\MAN\BD\5B_endpt.wav	mfctrain\5_9.mfc
wav\isolated_digits_ti_train_endpt\MAN\BD\6A_endpt.wav	mfctrain\6_8.mfc
wav\isolated_digits_ti_train_endpt\MAN\BD\6B_endpt.wav	mfctrain\6_9.mfc
wav\isolated_digits_ti_train_endpt\MAN\BD\7A_endpt.wav	mfctrain\7_8.mfc
wav\isolated_digits_ti_train_endpt\MAN\BD\7B_endpt.wav	mfctrain\7_9.mfc
wav\isolated_digits_ti_train_endpt\MAN\BD\8A_endpt.wav	mfctrain\8_8.mfc
wav\isolated_digits_ti_train_endpt\MAN\BD\8B_endpt.wav	mfctrain\8_9.mfc
wav\isolated_digits_ti_train_endpt\MAN\BD\9A_endpt.wav	mfctrain\9_8.mfc
wav\isolated_digits_ti_train_endpt\MAN\BD\9B_endpt.wav	mfctrain\9_9.mfc
wav\isolated_digits_ti_train_endpt\MAN\BD\OA_endpt.wav	mfctrain\10_8.mfc
wav\isolated_digits_ti_train_endpt\MAN\BD\OB_endpt.wav	mfctrain\10_9.mfc
wav\isolated_digits_ti_train_endpt\MAN\BD\ZA_endpt.wav	mfctrain\0_8.mfc
wav\isolated_digits_ti_train_endpt\MAN\BD\ZB_endpt.wav	mfctrain\0_9.mfc
wav\isolated_digits_ti_train_endpt\MAN\CB\1A_endpt.wav	mfctrain\1_10.mfc
wav\isolated_digits_ti_train_endpt\MAN\CB\1B_endpt.wav	mfctrain\1_11.mfc
wav\isolated_digits_ti_train_endpt\MAN\CB\2A_endpt.wav	mfctrain\2_10.mfc
wav\isolated_digits_ti_train_endpt\MAN\CB\2B_endpt.wav	mfctrain\2_11.mfc
wav\isolated_digits_ti_train_endpt\MAN\CB\3A_endpt.wav	mfctrain\3_10.mfc
wav\isolated_digits_ti_train_endpt\MAN\CB\3B_endpt.wav	mfctrain\3_11.mfc
wav\isolated_digits_ti_train_endpt\MAN\CB\4A_endpt.wav	mfctrain\4_10.mfc
wav\isolated_digits_ti_train_endpt\MAN\CB\4B_endpt.wav	mfctrain\4_11.mfc
wav\isolated_digits_ti_train_endpt\MAN\CB\5A_endpt.wav	mfctrain\5_10.mfc
wav\isolated_digits_ti_train_endpt\MAN\CB\5B_endpt.wav	mfctrain\5_11.mfc
wav\isolated_digits_ti_train_endpt\MAN\CB\6A_endpt.wav	mfctrain\6_10.mfc
wav\isolated_digits_ti_train_endpt\MAN\CB\6B_endpt.wav	mfctrain\6_11.mfc
wav\isolated_digits_ti_train_endpt\MAN\CB\7A_endpt.wav	mfctrain\7_10.mfc
wav\isolated_digits_ti_train_endpt\MAN\CB\7B_endpt.wav	mfctrain\7_11.mfc
wav\isolated_digits_ti_train_endpt\MAN\CB\8A_endpt.wav	mfctrain\8_10.mfc
wav\isolated_digits_ti_train_endpt\MAN\CB\8B_endpt.wav	mfctrain\8_11.mfc
wav\isolated_digits_ti_train_endpt\MAN\CB\9A_endpt.wav	mfctrain\9_10.mfc
wav\isolated_digits_ti_train_endpt\MAN\CB\9B_endpt.wav	mfctrain\9_11.mfc
wav\isolated_digits_ti_train_endpt\MAN\CB\OA_endpt.wav	mfctrain\10_10.mfc
wav\isolated_digits_ti_train_endpt\MAN\CB\OB_endpt.wav	mfctrain\10_11.mfc
wav\isolated_digits_ti_train_endpt\MAN\CB\ZA_endpt.wav	mfctrain\0_10.mfc
wav\isolated_digits_ti_train_endpt\MAN\CB\ZB_endpt.wav	mfctrain\0_11.mfc
wav\isolated_digits_ti_train_endpt\MAN\CF\1A_endpt.wav	mfctrain\1_12.mfc
wav\isolated_digits_ti_train_endpt\MAN\CF\1B_endpt.wav	mfctrain\1_13.mfc
wav\isolated_digits_ti_train_endpt\MAN\CF\2A_endpt.wav	mfctrain\2_12.mfc
wav\isolated_digits_ti_train_endpt\MAN\CF\2B_endpt.wav	mfctrain\2_13.mfc
wav\isolated_digits_ti_train_endpt\MAN\CF\3A_endpt.wav	mfctrain\3_12.mfc
wav\isolated_digits_ti_train_endpt\MAN\CF\3B_endpt.wav	mfctrain\3_13.mfc
wav\isolated_digits_ti_train_endpt\MAN\CF\4A_endpt.wav	mfctrain\4_12.mfc
wav\isolated_digits_ti_train_endpt\MAN\CF\4B_endpt.wav	mfctrain\4_13.mfc
wav\isolated_digits_ti_train_endpt\MAN\CF\5A_endpt.wav	mfctrain\5_12.mfc
wav\isolated_digits_ti_train_endpt\MAN\CF\5B_endpt.wav	mfctrain\5_13.mfc
wav\isolated_digits_ti_train_endpt\MAN\CF\6A_endpt.wav	mfctrain\6_12.mfc
wav\isolated_digits_ti_train_endpt\MAN\CF\6B_endpt.wav	mfctrain\6_13.mfc
wav\isolated_digits_ti_train_endpt\MAN\CF\7A_endpt.wav	mfctrain\7_12.mfc
wav\isolated_digits_ti_train_endpt\MAN\CF\7B_endpt.wav	mfctrain\7_13.mfc
wav\isolated_digits_ti_train_endpt\MAN\CF\8A_endpt.wav	mfctrain\8_12.mfc
wav\isolated_digits_ti_train_endpt\MAN\CF\8B_endpt.wav	mfctrain\8_13.mfc
wav\isolated_digits_ti_train_endpt\MAN\CF\9A_endpt.wav	mfctrain\9_12.mfc
wav\isolated_digits_ti_train_endpt\MAN\CF\9B_endpt.wav	mfctrain\9_13.mfc
wav\isolated_digits_ti_train_endpt\MAN\CF\OA_endpt.wav	mfctrain\10_12.mfc
wav\isolated_digits_ti_train_endpt\MAN\CF\OB_endpt.wav	mfctrain\10_13.mfc
wav\isolated_digits_ti_train_endpt\MAN\CF\ZA_endpt.wav	mfctrain\0_12.mfc
wav\isolated_digits_ti_train_endpt\MAN\CF\ZB_endpt.wav	mfctrain\0_13.mfc
wav\isolated_digits_ti_train_endpt\MAN\CR\1A_endpt.wav	mfctrain\1_14.mfc
wav\isolated_digits_ti_train_endpt\MAN\CR\1B_endpt.wav	mfctrain\1_15.mfc
wav\isolated_digits_ti_train_endpt\MAN\CR\2A_endpt.wav	mfctrain\2_14.mfc
wav\isolated_digits_ti_train_endpt\MAN\CR\2B_endpt.wav	mfctrain\2_15.mfc
wav\isolated_digits_ti_train_endpt\MAN\CR\3A_endpt.wav	mfctrain\3_14.mfc
wav\isolated_digits_ti_train_endpt\MAN\CR\3B_endpt.wav	mfctrain\3_15.mfc
wav\isolated_digits_ti_train_endpt\MAN\CR\4A_endpt.wav	mfctrain\4_14.mfc
wav\isolated_digits_ti_train_endpt\MAN\CR\4B_endpt.wav	mfctrain\4_15.mfc
wav\isolated_digits_ti_train_endpt\MAN\CR\5A_endpt.wav	mfctrain\5_14.mfc
wav\isolated_digits_ti_train_endpt\MAN\CR\5B_endpt.wav	mfctrain\5_15.mfc
wav\isolated_digits_ti_train_endpt\MAN\CR\6A_endpt.wav	mfctrain\6_14.mfc
wav\isolated_digits_ti_train_endpt\MAN\CR\6B_endpt.wav	mfctrain\6_15.mfc
wav\isolated_digits_ti_train_endpt\MAN\CR\7A_endpt.wav	mfctrain\7_14.mfc
wav\isolated_digits_ti_train_endpt\MAN\CR\7B_endpt.wav	mfctrain\7_15.mfc
wav\isolated_digits_ti_train_endpt\MAN\CR\8A_endpt.wav	mfctrain\8_14.mfc
wav\isolated_digits_ti_train_endpt\MAN\CR\8B_endpt.wav	mfctrain\8_15.mfc
wav\isolated_digits_ti_train_endpt\MAN\CR\9A_endpt.wav	mfctrain\9_14.mfc
wav\isolated_digits_ti_train_endpt\MAN\CR\9B_endpt.wav	mfctrain\9_15.mfc
wav\isolated_digits_ti_train_endpt\MAN\CR\OA_endpt.wav	mfctrain\10_14.mfc
wav\isolated_digits_ti_train_endpt\MAN\CR\OB_endpt.wav	mfctrain\10_15.mfc
wav\isolated_digits_ti_train_endpt\MAN\CR\ZA_endpt.wav	mfctrain\0_14.mfc
wav\isolated_digits_ti_train_endpt\MAN\CR\ZB_endpt.wav	mfctrain\0_15.mfc
wav\isolated_digits_ti_train_endpt\MAN\DL\1A_endpt.wav	mfctrain\1_16.mfc
wav\isolated_digits_ti_train_endpt\MAN\DL\1B_endpt.wav	mfctrain\1_17.mfc
wav\isolated_digits_ti_train_endpt\MAN\DL\2A_endpt.wav	mfctrain\2_16.mfc
wav\isolated_digits_ti_train_endpt\MAN\DL\2B_endpt.wav	mfctrain\2_17.mfc
wav\isolated_digits_ti_train_endpt\MAN\DL\3A_endpt.wav	mfctrain\3_16.mfc
wav\isolated_digits_ti_train_endpt\MAN\DL\3B_endpt.wav	mfctrain\3_17.mfc
wav\isolated_digits_ti_train_endpt\MAN\DL\4A_endpt.wav	mfctrain\4_16.mfc
wav\isolated_digits_ti_train_endpt\MAN\DL\4B_endpt.wav	mfctrain\4_17.mfc
wav\isolated_digits_ti_train_endpt\MAN\DL\5A_endpt.wav	mfctrain\5_16.mfc
wav\isolated_digits_ti_train_endpt\MAN\DL\5B_endpt.wav	mfctrain\5_17.mfc
wav\isolated_digits_ti_train_endpt\MAN\DL\6A_endpt.wav	mfctrain\6_16.mfc
wav\isolated_digits_ti_train_endpt\MAN\DL\6B_endpt.wav	mfctrain\6_17.mfc
wav\isolated_digits_ti_train_endpt\MAN\DL\7A_endpt.wav	mfctrain\7_16.mfc
wav\isolated_digits_ti_train_endpt\MAN\DL\7B_endpt.wav	mfctrain\7_17.mfc
wav\isolated_digits_ti_train_endpt\MAN\DL\8A_endpt.wav	mfctrain\8_16.mfc
wav\isolated_digits_ti_train_endpt\MAN\DL\8B_endpt.wav	mfctrain\8_17.mfc
wav\isolated_digits_ti_train_endpt\MAN\DL\9A_endpt.wav	mfctrain\9_16.mfc
wav\isolated_digits_ti_train_endpt\MAN\DL\9B_endpt.wav	mfctrain\9_17.mfc
wav\isolated_digits_ti_train_endpt\MAN\DL\OA_endpt.wav	mfctrain\10_16.mfc
wav\isolated_digits_ti_train_endpt\MAN\DL\OB_endpt.wav	mfctrain\10_17.mfc
wav\isolated_digits_ti_train_endpt\MAN\DL\ZA_endpt.wav	mfctrain\0_16.mfc
wav\isolated_digits_ti_train_endpt\MAN\DL\ZB_endpt.wav	mfctrain\0_17.mfc
wav\isolated_digits_ti_train_endpt\MAN\DN\1A_endpt.wav	mfctrain\1_18.mfc
wav\isolated_digits_ti_train_endpt\MAN\DN\1B_endpt.wav	mfctrain\1_19.mfc
wav\isolated_digits_ti_train_endpt\MAN\DN\2A_endpt.wav	mfctrain\2_18.mfc
wav\isolated_digits_ti_train_endpt\MAN\DN\2B_endpt.wav	mfctrain\2_19.mfc
wav\isolated_digits_ti_train_endpt\MAN\DN\3A_endpt.wav	mfctrain\3_18.mfc
wav\isolated_digits_ti_train_endpt\MAN\DN\3B_endpt.wav	mfctrain\3_19.mfc
wav\isolated_digits_ti_train_endpt\MAN\DN\4A_endpt.wav	mfctrain\4_18.mfc
wav\isolated_digits_ti_train_endpt\MAN\DN\4B_endpt.wav	mfctrain\4_19.mfc
wav\isolated_digits_ti_train_endpt\MAN\DN\5A_endpt.wav	mfctrain\5_18.mfc
wav\isolated_digits_ti_train_endpt\MAN\DN\5B_endpt.wav	mfctrain\5_19.mfc
wav\isolated_digits_ti_train_endpt\MAN\DN\6A_endpt.wav	mfctrain\6_18.mfc
wav\isolated_digits_ti_train_endpt\MAN\DN\6B_endpt.wav	mfctrain\6_19.mfc
wav\isolated_digits_ti_train_endpt\MAN\DN\7A_endpt.wav	mfctrain\7_18.mfc
wav\isolated_digits_ti_train_endpt\MAN\DN\7B_endpt.wav	mfctrain\7_19.mfc
wav\isolated_digits_ti_train_endpt\MAN\DN\8A_endpt.wav	mfctrain\8_18.mfc
wav\isolated_digits_ti_train_endpt\MAN\DN\8B_endpt.wav	mfctrain\8_19.mfc
wav\isolated_digits_ti_train_endpt\MAN\DN\9A_endpt.wav	mfctrain\9_18.mfc
wav\isolated_digits_ti_train_endpt\MAN\DN\9B_endpt.wav	mfctrain\9_19.mfc
wav\isolated_digits_ti_train_endpt\MAN\DN\OA_endpt.wav	mfctrain\10_18.mfc
wav\isolated_digits_ti_train_endpt\MAN\DN\OB_endpt.wav	mfctrain\10_19.mfc
wav\isolated_digits_ti_train_endpt\MAN\DN\ZA_endpt.wav	mfctrain\0_18.mfc
wav\isolated_digits_ti_train_endpt\MAN\DN\ZB_endpt.wav	mfctrain\0_19.mfc
wav\isolated_digits_ti_train_endpt\MAN\EH\1A_endpt.wav	mfctrain\1_20.mfc
wav\isolated_digits_ti_train_endpt\MAN\EH\1B_endpt.wav	mfctrain\1_21.mfc
wav\isolated_digits_ti_train_endpt\MAN\EH\2A_endpt.wav	mfctrain\2_20.mfc
wav\isolated_digits_ti_train_endpt\MAN\EH\2B_endpt.wav	mfctrain\2_21.mfc
wav\isolated_digits_ti_train_endpt\MAN\EH\3A_endpt.wav	mfctrain\3_20.mfc
wav\isolated_digits_ti_train_endpt\MAN\EH\3B_endpt.wav	mfctrain\3_21.mfc
wav\isolated_digits_ti_train_endpt\MAN\EH\4A_endpt.wav	mfctrain\4_20.mfc
wav\isolated_digits_ti_train_endpt\MAN\EH\4B_endpt.wav	mfctrain\4_21.mfc
wav\isolated_digits_ti_train_endpt\MAN\EH\5A_endpt.wav	mfctrain\5_20.mfc
wav\isolated_digits_ti_train_endpt\MAN\EH\5B_endpt.wav	mfctrain\5_21.mfc
wav\isolated_digits_ti_train_endpt\MAN\EH\6A_endpt.wav	mfctrain\6_20.mfc
wav\isolated_digits_ti_train_endpt\MAN\EH\6B_endpt.wav	mfctrain\6_21.mfc
wav\isolated_digits_ti_train_endpt\MAN\EH\7A_endpt.wav	mfctrain\7_20.mfc
wav\isolated_digits_ti_train_endpt\MAN\EH\7B_endpt.wav	mfctrain\7_21.mfc
wav\isolated_digits_ti_train_endpt\MAN\EH\8A_endpt.wav	mfctrain\8_20.mfc
wav\isolated_digits_ti_train_endpt\MAN\EH\8B_endpt.wav	mfctrain\8_21.mfc
wav\isolated_digits_ti_train_endpt\MAN\EH\9A_endpt.wav	mfctrain\9_20.mfc
wav\isolated_digits_ti_train_endpt\MAN\EH\9B_endpt.wav	mfctrain\9_21.mfc
wav\isolated_digits_ti_train_endpt\MAN\EH\OA_endpt.wav	mfctrain\10_20.mfc
wav\isolated_digits_ti_train_endpt\MAN\EH\OB_endpt.wav	mfctrain\10_21.mfc
wav\isolated_digits_ti_train_endpt\MAN\EH\ZA_endpt.wav	mfctrain\0_20.mfc
wav\isolated_digits_ti_train_endpt\MAN\EH\ZB_endpt.wav	mfctrain\0_21.mfc
wav\isolated_digits_ti_train_endpt\MAN\EL\1A_endpt.wav	mfctrain\1_22.mfc
wav\isolated_digits_ti_train_endpt\MAN\EL\1B_endpt.wav	mfctrain\1_23.mfc
wav\isolated_digits_ti_train_endpt\MAN\EL\2A_endpt.wav	mfctrain\2_22.mfc
wav\isolated_digits_ti_train_endpt\MAN\EL\2B_endpt.wav	mfctrain\2_23.mfc
wav\isolated_digits_ti_train_endpt\MAN\EL\3A_endpt.wav	mfctrain\3_22.mfc
wav\isolated_digits_ti_train_endpt\MAN\EL\3B_endpt.wav	mfctrain\3_23.mfc
wav\isolated_digits_ti_train_endpt\MAN\EL\4A_endpt.wav	mfctrain\4_22.mfc
wav\isolated_digits_ti_train_endpt\MAN\EL\4B_endpt.wav	mfctrain\4_23.mfc
wav\isolated_digits_ti_train_endpt\MAN\EL\5A_endpt.wav	mfctrain\5_22.mfc
wav\isolated_digits_ti_train_endpt\MAN\EL\5B_endpt.wav	mfctrain\5_23.mfc
wav\isolated_digits_ti_train_endpt\MAN\EL\6A_endpt.wav	mfctrain\6_22.mfc
wav\isolated_digits_ti_train_endpt\MAN\EL\6B_endpt.wav	mfctrain\6_23.mfc
wav\isolated_digits_ti_train_endpt\MAN\EL\7A_endpt.wav	mfctrain\7_22.mfc
wav\isolated_digits_ti_train_endpt\MAN\EL\7B_endpt.wav	mfctrain\7_23.mfc
wav\isolated_digits_ti_train_endpt\MAN\EL\8A_endpt.wav	mfctrain\8_22.mfc
wav\isolated_digits_ti_train_endpt\MAN\EL\8B_endpt.wav	mfctrain\8_23.mfc
wav\isolated_digits_ti_train_endpt\MAN\EL\9A_endpt.wav	mfctrain\9_22.mfc
wav\isolated_digits_ti_train_endpt\MAN\EL\9B_endpt.wav	mfctrain\9_23.mfc
wav\isolated_digits_ti_train_endpt\MAN\EL\OA_endpt.wav	mfctrain\10_22.mfc
wav\isolated_digits_ti_train_endpt\MAN\EL\OB_endpt.wav	mfctrain\10_23.mfc
wav\isolated_digits_ti_train_endpt\MAN\EL\ZA_endpt.wav	mfctrain\0_22.mfc
wav\isolated_digits_ti_train_endpt\MAN\EL\ZB_endpt.wav	mfctrain\0_23.mfc
wav\isolated_digits_ti_train_endpt\MAN\FC\1A_endpt.wav	mfctrain\1_24.mfc
wav\isolated_digits_ti_train_endpt\MAN\FC\1B_endpt.wav	mfctrain\1_25.mfc
wav\isolated_digits_ti_train_endpt\MAN\FC\2A_endpt.wav	mfctrain\2_24.mfc
wav\isolated_digits_ti_train_endpt\MAN\FC\2B_endpt.wav	mfctrain\2_25.mfc
wav\isolated_digits_ti_train_endpt\MAN\FC\3A_endpt.wav	mfctrain\3_24.mfc
wav\isolated_digits_ti_train_endpt\MAN\FC\3B_endpt.wav	mfctrain\3_25.mfc
wav\isolated_digits_ti_train_endpt\MAN\FC\4A_endpt.wav	mfctrain\4_24.mfc
wav\isolated_digits_ti_train_endpt\MAN\FC\4B_endpt.wav	mfctrain\4_25.mfc
wav\isolated_digits_ti_train_endpt\MAN\FC\5A_endpt.wav	mfctrain\5_24.mfc
wav\isolated_digits_ti_train_endpt\MAN\FC\5B_endpt.wav	mfctrain\5_25.mfc
wav\isolated_digits_ti_train_endpt\MAN\FC\6A_endpt.wav	mfctrain\6_24.mfc
wav\isolated_digits_ti_train_endpt\MAN\FC\6B_endpt.wav	mfctrain\6_25.mfc
wav\isolated_digits_ti_train_endpt\MAN\FC\7A_endpt.wav	mfctrain\7_24.mfc
wav\isolated_digits_ti_train_endpt\MAN\FC\7B_endpt.wav	mfctrain\7_25.mfc
wav\isolated_digits_ti_train_endpt\MAN\FC\8A_endpt.wav	mfctrain\8_24.mfc
wav\isolated_digits_ti_train_endpt\MAN\FC\8B_endpt.wav	mfctrain\8_25.mfc
wav\isolated_digits_ti_train_endpt\MAN\FC\9A_endpt.wav	mfctrain\9_24.mfc
wav\isolated_digits_ti_train_endpt\MAN\FC\9B_endpt.wav	mfctrain\9_25.mfc
wav\isolated_digits_ti_train_endpt\MAN\FC\OA_endpt.wav	mfctrain\10_24.mfc
wav\isolated_digits_ti_train_endpt\MAN\FC\OB_endpt.wav	mfctrain\10_25.mfc
wav\isolated_digits_ti_train_endpt\MAN\FC\ZA_endpt.wav	mfctrain\0_24.mfc
wav\isolated_digits_ti_train_endpt\MAN\FC\ZB_endpt.wav	mfctrain\0_25.mfc
wav\isolated_digits_ti_train_endpt\MAN\FD\1A_endpt.wav	mfctrain\1_26.mfc
wav\isolated_digits_ti_train_endpt\MAN\FD\1B_endpt.wav	mfctrain\1_27.mfc
wav\isolated_digits_ti_train_endpt\MAN\FD\2A_endpt.wav	mfctrain\2_26.mfc
wav\isolated_digits_ti_train_endpt\MAN\FD\2B_endpt.wav	mfctrain\2_27.mfc
wav\isolated_digits_ti_train_endpt\MAN\FD\3A_endpt.wav	mfctrain\3_26.mfc
wav\isolated_digits_ti_train_endpt\MAN\FD\3B_endpt.wav	mfctrain\3_27.mfc
wav\isolated_digits_ti_train_endpt\MAN\FD\4A_endpt.wav	mfctrain\4_26.mfc
wav\isolated_digits_ti_train_endpt\MAN\FD\4B_endpt.wav	mfctrain\4_27.mfc
wav\isolated_digits_ti_train_endpt\MAN\FD\5A_endpt.wav	mfctrain\5_26.mfc
wav\isolated_digits_ti_train_endpt\MAN\FD\5B_endpt.wav	mfctrain\5_27.mfc
wav\isolated_digits_ti_train_endpt\MAN\FD\6A_endpt.wav	mfctrain\6_26.mfc
wav\isolated_digits_ti_train_endpt\MAN\FD\6B_endpt.wav	mfctrain\6_27.mfc
wav\isolated_digits_ti_train_endpt\MAN\FD\7A_endpt.wav	mfctrain\7_26.mfc
wav\isolated_digits_ti_train_endpt\MAN\FD\7B_endpt.wav	mfctrain\7_27.mfc
wav\isolated_digits_ti_train_endpt\MAN\FD\8A_endpt.wav	mfctrain\8_26.mfc
wav\isolated_digits_ti_train_endpt\MAN\FD\8B_endpt.wav	mfctrain\8_27.mfc
wav\isolated_digits_ti_train_endpt\MAN\FD\9A_endpt.wav	mfctrain\9_26.mfc
wav\isolated_digits_ti_train_endpt\MAN\FD\9B_endpt.wav	mfctrain\9_27.mfc
wav\isolated_digits_ti_train_endpt\MAN\FD\OA_endpt.wav	mfctrain\10_26.mfc
wav\isolated_digits_ti_train_endpt\MAN\FD\OB_endpt.wav	mfctrain\10_27.mfc
wav\isolated_digits_ti_train_endpt\MAN\FD\ZA_endpt.wav	mfctrain\0_26.mfc
wav\isolated_digits_ti_train_endpt\MAN\FD\ZB_endpt.wav	mfctrain\0_27.mfc
wav\isolated_digits_ti_train_endpt\MAN\FF\1A_endpt.wav	mfctrain\1_28.mfc
wav\isolated_digits_ti_train_endpt\MAN\FF\1B_endpt.wav	mfctrain\1_29.mfc
wav\isolated_digits_ti_train_endpt\MAN\FF\2A_endpt.wav	mfctrain\2_28.mfc
wav\isolated_digits_ti_train_endpt\MAN\FF\2B_endpt.wav	mfctrain\2_29.mfc
wav\isolated_digits_ti_train_endpt\MAN\FF\3A_endpt.wav	mfctrain\3_28.mfc
wav\isolated_digits_ti_train_endpt\MAN\FF\3B_endpt.wav	mfctrain\3_29.mfc
wav\isolated_digits_ti_train_endpt\MAN\FF\4A_endpt.wav	mfctrain\4_28.mfc
wav\isolated_digits_ti_train_endpt\MAN\FF\4B_endpt.wav	mfctrain\4_29.mfc
wav\isolated_digits_ti_train_endpt\MAN\FF\5A_endpt.wav	mfctrain\5_28.mfc
wav\isolated_digits_ti_train_endpt\MAN\FF\5B_endpt.wav	mfctrain\5_29.mfc
wav\isolated_digits_ti_train_endpt\MAN\FF\6A_endpt.wav	mfctrain\6_28.mfc
wav\isolated_digits_ti_train_endpt\MAN\FF\6B_endpt.wav	mfctrain\6_29.mfc
wav\isolated_digits_ti_train_endpt\MAN\FF\7A_endpt.wav	mfctrain\7_28.mfc
wav\isolated_digits_ti_train_endpt\MAN\FF\7B_endpt.wav	mfctrain\7_29.mfc
wav\isolated_digits_ti_train_endpt\MAN\FF\8A_endpt.wav	mfctrain\8_28.mfc
wav\isolated_digits_ti_train_endpt\MAN\FF\8B_endpt.wav	mfctrain\8_29.mfc
wav\isolated_digits_ti_train_endpt\MAN\FF\9A_endpt.wav	mfctrain\9_28.mfc
wav\isolated_digits_ti_train_endpt\MAN\FF\9B_endpt.wav	mfctrain\9_29.mfc
wav\isolated_digits_ti_train_endpt\MAN\FF\OA_endpt.wav	mfctrain\10_28.mfc
wav\isolated_digits_ti_train_endpt\MAN\FF\OB_endpt.wav	mfctrain\10_29.mfc
wav\isolated_digits_ti_train_endpt\MAN\FF\ZA_endpt.wav	mfctrain\0_28.mfc
wav\isolated_digits_ti_train_endpt\MAN\FF\ZB_endpt.wav	mfctrain\0_29.mfc
wav\isolated_digits_ti_train_endpt\MAN\FI\1A_endpt.wav	mfctrain\1_30.mfc
wav\isolated_digits_ti_train_endpt\MAN\FI\1B_endpt.wav	mfctrain\1_31.mfc
wav\isolated_digits_ti_train_endpt\MAN\FI\2A_endpt.wav	mfctrain\2_30.mfc
wav\isolated_digits_ti_train_endpt\MAN\FI\2B_endpt.wav	mfctrain\2_31.mfc
wav\isolated_digits_ti_train_endpt\MAN\FI\3A_endpt.wav	mfctrain\3_30.mfc
wav\isolated_digits_ti_train_endpt\MAN\FI\3B_endpt.wav	mfctrain\3_31.mfc
wav\isolated_digits_ti_train_endpt\MAN\FI\4A_endpt.wav	mfctrain\4_30.mfc
wav\isolated_digits_ti_train_endpt\MAN\FI\4B_endpt.wav	mfctrain\4_31.mfc
wav\isolated_digits_ti_train_endpt\MAN\FI\5A_endpt.wav	mfctrain\5_30.mfc
wav\isolated_digits_ti_train_endpt\MAN\FI\5B_endpt.wav	mfctrain\5_31.mfc
wav\isolated_digits_ti_train_endpt\MAN\FI\6A_endpt.wav	mfctrain\6_30.mfc
wav\isolated_digits_ti_train_endpt\MAN\FI\6B_endpt.wav	mfctrain\6_31.mfc
wav\isolated_digits_ti_train_endpt\MAN\FI\7A_endpt.wav	mfctrain\7_30.mfc
wav\isolated_digits_ti_train_endpt\MAN\FI\7B_endpt.wav	mfctrain\7_31.mfc
wav\isolated_digits_ti_train_endpt\MAN\FI\8A_endpt.wav	mfctrain\8_30.mfc
wav\isolated_digits_ti_train_endpt\MAN\FI\8B_endpt.wav	mfctrain\8_31.mfc
wav\isolated_digits_ti_train_endpt\MAN\FI\9A_endpt.wav	mfctrain\9_30.mfc
wav\isolated_digits_ti_train_endpt\MAN\FI\9B_endpt.wav	mfctrain\9_31.mfc
wav\isolated_digits_ti_train_endpt\MAN\FI\OA_endpt.wav	mfctrain\10_30.mfc
wav\isolated_digits_ti_train_endpt\MAN\FI\OB_endpt.wav	mfctrain\10_31.mfc
wav\isolated_digits_ti_train_endpt\MAN\FI\ZA_endpt.wav	mfctrain\0_30.mfc
wav\isolated_digits_ti_train_endpt\MAN\FI\ZB_endpt.wav	mfctrain\0_31.mfc
wav\isolated_digits_ti_train_endpt\MAN\FJ\1A_endpt.wav	mfctrain\1_32.mfc
wav\isolated_digits_ti_train_endpt\MAN\FJ\1B_endpt.wav	mfctrain\1_33.mfc
wav\isolated_digits_ti_train_endpt\MAN\FJ\2A_endpt.wav	mfctrain\2_32.mfc
wav\isolated_digits_ti_train_endpt\MAN\FJ\2B_endpt.wav	mfctrain\2_33.mfc
wav\isolated_digits_ti_train_endpt\MAN\FJ\3A_endpt.wav	mfctrain\3_32.mfc
wav\isolated_digits_ti_train_endpt\MAN\FJ\3B_endpt.wav	mfctrain\3_33.mfc
wav\isolated_digits_ti_train_endpt\MAN\FJ\4A_endpt.wav	mfctrain\4_32.mfc
wav\isolated_digits_ti_train_endpt\MAN\FJ\4B_endpt.wav	mfctrain\4_33.mfc
wav\isolated_digits_ti_train_endpt\MAN\FJ\5A_endpt.wav	mfctrain\5_32.mfc
wav\isolated_digits_ti_train_endpt\MAN\FJ\5B_endpt.wav	mfctrain\5_33.mfc
wav\isolated_digits_ti_train_endpt\MAN\FJ\6A_endpt.wav	mfctrain\6_32.mfc
wav\isolated_digits_ti_train_endpt\MAN\FJ\6B_endpt.wav	mfctrain\6_33.mfc
wav\isolated_digits_ti_train_endpt\MAN\FJ\7A_endpt.wav	mfctrain\7_32.mfc
wav\isolated_digits_ti_train_endpt\MAN\FJ\7B_endpt.wav	mfctrain\7_33.mfc
wav\isolated_digits_ti_train_endpt\MAN\FJ\8A_endpt.wav	mfctrain\8_32.mfc
wav\isolated_digits_ti_train_endpt\MAN\FJ\8B_endpt.wav	mfctrain\8_33.mfc
wav\isolated_digits_ti_train_endpt\MAN\FJ\9A_endpt.wav	mfctrain\9_32.mfc
wav\isolated_digits_ti_train_endpt\MAN\FJ\9B_endpt.wav	mfctrain\9_33.mfc
wav\isolated_digits_ti_train_endpt\MAN\FJ\OA_endpt.wav	mfctrain\10_32.mfc
wav\isolated_digits_ti_train_endpt\MAN\FJ\OB_endpt.wav	mfctrain\10_33.mfc
wav\isolated_digits_ti_train_endpt\MAN\FJ\ZA_endpt.wav	mfctrain\0_32.mfc
wav\isolated_digits_ti_train_endpt\MAN\FJ\ZB_endpt.wav	mfctrain\0_33.mfc
wav\isolated_digits_ti_train_endpt\MAN\FK\1A_endpt.wav	mfctrain\1_34.mfc
wav\isolated_digits_ti_train_endpt\MAN\FK\1B_endpt.wav	mfctrain\1_35.mfc
wav\isolated_digits_ti_train_endpt\MAN\FK\2A_endpt.wav	mfctrain\2_34.mfc
wav\isolated_digits_ti_train_endpt\MAN\FK\2B_endpt.wav	mfctrain\2_35.mfc
wav\isolated_digits_ti_train_endpt\MAN\FK\3A_endpt.wav	mfctrain\3_34.mfc
wav\isolated_digits_ti_train_endpt\MAN\FK\3B_endpt.wav	mfctrain\3_35.mfc
wav\isolated_digits_ti_train_endpt\MAN\FK\4A_endpt.wav	mfctrain\4_34.mfc
wav\isolated_digits_ti_train_endpt\MAN\FK\4B_endpt.wav	mfctrain\4_35.mfc
wav\isolated_digits_ti_train_endpt\MAN\FK\5A_endpt.wav	mfctrain\5_34.mfc
wav\isolated_digits_ti_train_endpt\MAN\FK\5B_endpt.wav	mfctrain\5_35.mfc
wav\isolated_digits_ti_train_endpt\MAN\FK\6A_endpt.wav	mfctrain\6_34.mfc
wav\isolated_digits_ti_train_endpt\MAN\FK\6B_endpt.wav	mfctrain\6_35.mfc
wav\isolated_digits_ti_train_endpt\MAN\FK\7A_endpt.wav	mfctrain\7_34.mfc
wav\isolated_digits_ti_train_endpt\MAN\FK\7B_endpt.wav	mfctrain\7_35.mfc
wav\isolated_digits_ti_train_endpt\MAN\FK\8A_endpt.wav	mfctrain\8_34.mfc
wav\isolated_digits_ti_train_endpt\MAN\FK\8B_endpt.wav	mfctrain\8_35.mfc
wav\isolated_digits_ti_train_endpt\MAN\FK\9A_endpt.wav	mfctrain\9_34.mfc
wav\isolated_digits_ti_train_endpt\MAN\FK\9B_endpt.wav	mfctrain\9_35.mfc
wav\isolated_digits_ti_train_endpt\MAN\FK\OA_endpt.wav	mfctrain\10_34.mfc
wav\isolated_digits_ti_train_endpt\MAN\FK\OB_endpt.wav	mfctrain\10_35.mfc
wav\isolated_digits_ti_train_endpt\MAN\FK\ZA_endpt.wav	mfctrain\0_34.mfc
wav\isolated_digits_ti_train_endpt\MAN\FK\ZB_endpt.wav	mfctrain\0_35.mfc
wav\isolated_digits_ti_train_endpt\MAN\FL\1A_endpt.wav	mfctrain\1_36.mfc
wav\isolated_digits_ti_train_endpt\MAN\FL\1B_endpt.wav	mfctrain\1_37.mfc
wav\isolated_digits_ti_train_endpt\MAN\FL\2A_endpt.wav	mfctrain\2_36.mfc
wav\isolated_digits_ti_train_endpt\MAN\FL\2B_endpt.wav	mfctrain\2_37.mfc
wav\isolated_digits_ti_train_endpt\MAN\FL\3A_endpt.wav	mfctrain\3_36.mfc
wav\isolated_digits_ti_train_endpt\MAN\FL\3B_endpt.wav	mfctrain\3_37.mfc
wav\isolated_digits_ti_train_endpt\MAN\FL\4A_endpt.wav	mfctrain\4_36.mfc
wav\isolated_digits_ti_train_endpt\MAN\FL\4B_endpt.wav	mfctrain\4_37.mfc
wav\isolated_digits_ti_train_endpt\MAN\FL\5A_endpt.wav	mfctrain\5_36.mfc
wav\isolated_digits_ti_train_endpt\MAN\FL\5B_endpt.wav	mfctrain\5_37.mfc
wav\isolated_digits_ti_train_endpt\MAN\FL\6A_endpt.wav	mfctrain\6_36.mfc
wav\isolated_digits_ti_train_endpt\MAN\FL\6B_endpt.wav	mfctrain\6_37.mfc
wav\isolated_digits_ti_train_endpt\MAN\FL\7A_endpt.wav	mfctrain\7_36.mfc
wav\isolated_digits_ti_train_endpt\MAN\FL\7B_endpt.wav	mfctrain\7_37.mfc
wav\isolated_digits_ti_train_endpt\MAN\FL\8A_endpt.wav	mfctrain\8_36.mfc
wav\isolated_digits_ti_train_endpt\MAN\FL\8B_endpt.wav	mfctrain\8_37.mfc
wav\isolated_digits_ti_train_endpt\MAN\FL\9A_endpt.wav	mfctrain\9_36.mfc
wav\isolated_digits_ti_train_endpt\MAN\FL\9B_endpt.wav	mfctrain\9_37.mfc
wav\isolated_digits_ti_train_endpt\MAN\FL\OA_endpt.wav	mfctrain\10_36.mfc
wav\isolated_digits_ti_train_endpt\MAN\FL\OB_endpt.wav	mfctrain\10_37.mfc
wav\isolated_digits_ti_train_endpt\MAN\FL\ZA_endpt.wav	mfctrain\0_36.mfc
wav\isolated_digits_ti_train_endpt\MAN\FL\ZB_endpt.wav	mfctrain\0_37.mfc
wav\isolated_digits_ti_train_endpt\MAN\GG\1A_endpt.wav	mfctrain\1_38.mfc
wav\isolated_digits_ti_train_endpt\MAN\GG\1B_endpt.wav	mfctrain\1_39.mfc
wav\isolated_digits_ti_train_endpt\MAN\GG\2A_endpt.wav	mfctrain\2_38.mfc
wav\isolated_digits_ti_train_endpt\MAN\GG\2B_endpt.wav	mfctrain\2_39.mfc
wav\isolated_digits_ti_train_endpt\MAN\GG\3A_endpt.wav	mfctrain\3_38.mfc
wav\isolated_digits_ti_train_endpt\MAN\GG\3B_endpt.wav	mfctrain\3_39.mfc
wav\isolated_digits_ti_train_endpt\MAN\GG\4A_endpt.wav	mfctrain\4_38.mfc
wav\isolated_digits_ti_train_endpt\MAN\GG\4B_endpt.wav	mfctrain\4_39.mfc
wav\isolated_digits_ti_train_endpt\MAN\GG\5A_endpt.wav	mfctrain\5_38.mfc
wav\isolated_digits_ti_train_endpt\MAN\GG\5B_endpt.wav	mfctrain\5_39.mfc
wav\isolated_digits_ti_train_endpt\MAN\GG\6A_endpt.wav	mfctrain\6_38.mfc
wav\isolated_digits_ti_train_endpt\MAN\GG\6B_endpt.wav	mfctrain\6_39.mfc
wav\isolated_digits_ti_train_endpt\MAN\GG\7A_endpt.wav	mfctrain\7_38.mfc
wav\isolated_digits_ti_train_endpt\MAN\GG\7B_endpt.wav	mfctrain\7_39.mfc
wav\isolated_digits_ti_train_endpt\MAN\GG\8A_endpt.wav	mfctrain\8_38.mfc
wav\isolated_digits_ti_train_endpt\MAN\GG\8B_endpt.wav	mfctrain\8_39.mfc
wav\isolated_digits_ti_train_endpt\MAN\GG\9A_endpt.wav	mfctrain\9_38.mfc
wav\isolated_digits_ti_train_endpt\MAN\GG\9B_endpt.wav	mfctrain\9_39.mfc
wav\isolated_digits_ti_train_endpt\MAN\GG\OA_endpt.wav	mfctrain\10_38.mfc
wav\isolated_digits_ti_train_endpt\MAN\GG\OB_endpt.wav	mfctrain\10_39.mfc
wav\isolated_digits_ti_train_endpt\MAN\GG\ZA_endpt.wav	mfctrain\0_38.mfc
wav\isolated_digits_ti_train_endpt\MAN\GG\ZB_endpt.wav	mfctrain\0_39.mfc
wav\isolated_digits_ti_train_endpt\MAN\GJ\1A_endpt.wav	mfctrain\1_40.mfc
wav\isolated_digits_ti_train_endpt\MAN\GJ\1B_endpt.wav	mfctrain\1_41.mfc
wav\isolated_digits_ti_train_endpt\MAN\GJ\2A_endpt.wav	mfctrain\2_40.mfc
wav\isolated_digits_ti_train_endpt\MAN\GJ\2B_endpt.wav	mfctrain\2_41.mfc
wav\isolated_digits_ti_train_endpt\MAN\GJ\3A_endpt.wav	mfctrain\3_40.mfc
wav\isolated_digits_ti_train_endpt\MAN\GJ\3B_endpt.wav	mfctrain\3_41.mfc
wav\isolated_digits_ti_train_endpt\MAN\GJ\4A_endpt.wav	mfctrain\4_40.mfc
wav\isolated_digits_ti_train_endpt\MAN\GJ\4B_endpt.wav	mfctrain\4_41.mfc
wav\isolated_digits_ti_train_endpt\MAN\GJ\5A_endpt.wav	mfctrain\5_40.mfc
wav\isolated_digits_ti_train_endpt\MAN\GJ\5B_endpt.wav	mfctrain\5_41.mfc
wav\isolated_digits_ti_train_endpt\MAN\GJ\6A_endpt.wav	mfctrain\6_40.mfc
wav\isolated_digits_ti_train_endpt\MAN\GJ\6B_endpt.wav	mfctrain\6_41.mfc
wav\isolated_digits_ti_train_endpt\MAN\GJ\7A_endpt.wav	mfctrain\7_40.mfc
wav\isolated_digits_ti_train_endpt\MAN\GJ\7B_endpt.wav	mfctrain\7_41.mfc
wav\isolated_digits_ti_train_endpt\MAN\GJ\8A_endpt.wav	mfctrain\8_40.mfc
wav\isolated_digits_ti_train_endpt\MAN\GJ\8B_endpt.wav	mfctrain\8_41.mfc
wav\isolated_digits_ti_train_endpt\MAN\GJ\9A_endpt.wav	mfctrain\9_40.mfc
wav\isolated_digits_ti_train_endpt\MAN\GJ\9B_endpt.wav	mfctrain\9_41.mfc
wav\isolated_digits_ti_train_endpt\MAN\GJ\OA_endpt.wav	mfctrain\10_40.mfc
wav\isolated_digits_ti_train_endpt\MAN\GJ\OB_endpt.wav	mfctrain\10_41.mfc
wav\isolated_digits_ti_train_endpt\MAN\GJ\ZA_endpt.wav	mfctrain\0_40.mfc
wav\isolated_digits_ti_train_endpt\MAN\GJ\ZB_endpt.wav	mfctrain\0_41.mfc
wav\isolated_digits_ti_train_endpt\MAN\GR\1A_endpt.wav	mfctrain\1_42.mfc
wav\isolated_digits_ti_train_endpt\MAN\GR\1B_endpt.wav	mfctrain\1_43.mfc
wav\isolated_digits_ti_train_endpt\MAN\GR\2A_endpt.wav	mfctrain\2_42.mfc
wav\isolated_digits_ti_train_endpt\MAN\GR\2B_endpt.wav	mfctrain\2_43.mfc
wav\isolated_digits_ti_train_endpt\MAN\GR\3A_endpt.wav	mfctrain\3_42.mfc
wav\isolated_digits_ti_train_endpt\MAN\GR\3B_endpt.wav	mfctrain\3_43.mfc
wav\isolated_digits_ti_train_endpt\MAN\GR\4A_endpt.wav	mfctrain\4_42.mfc
wav\isolated_digits_ti_train_endpt\MAN\GR\4B_endpt.wav	mfctrain\4_43.mfc
wav\isolated_digits_ti_train_endpt\MAN\GR\5A_endpt.wav	mfctrain\5_42.mfc
wav\isolated_digits_ti_train_endpt\MAN\GR\5B_endpt.wav	mfctrain\5_43.mfc
wav\isolated_digits_ti_train_endpt\MAN\GR\6A_endpt.wav	mfctrain\6_42.mfc
wav\isolated_digits_ti_train_endpt\MAN\GR\6B_endpt.wav	mfctrain\6_43.mfc
wav\isolated_digits_ti_train_endpt\MAN\GR\7A_endpt.wav	mfctrain\7_42.mfc
wav\isolated_digits_ti_train_endpt\MAN\GR\7B_endpt.wav	mfctrain\7_43.mfc
wav\isolated_digits_ti_train_endpt\MAN\GR\8A_endpt.wav	mfctrain\8_42.mfc
wav\isolated_digits_ti_train_endpt\MAN\GR\8B_endpt.wav	mfctrain\8_43.mfc
wav\isolated_digits_ti_train_endpt\MAN\GR\9A_endpt.wav	mfctrain\9_42.mfc
wav\isolated_digits_ti_train_endpt\MAN\GR\9B_endpt.wav	mfctrain\9_43.mfc
wav\isolated_digits_ti_train_endpt\MAN\GR\OA_endpt.wav	mfctrain\10_42.mfc
wav\isolated_digits_ti_train_endpt\MAN\GR\OB_endpt.wav	mfctrain\10_43.mfc
wav\isolated_digits_ti_train_endpt\MAN\GR\ZA_endpt.wav	mfctrain\0_42.mfc
wav\isolated_digits_ti_train_endpt\MAN\GR\ZB_endpt.wav	mfctrain\0_43.mfc
wav\isolated_digits_ti_train_endpt\MAN\GT\1A_endpt.wav	mfctrain\1_44.mfc
wav\isolated_digits_ti_train_endpt\MAN\GT\1B_endpt.wav	mfctrain\1_45.mfc
wav\isolated_digits_ti_train_endpt\MAN\GT\2A_endpt.wav	mfctrain\2_44.mfc
wav\isolated_digits_ti_train_endpt\MAN\GT\2B_endpt.wav	mfctrain\2_45.mfc
wav\isolated_digits_ti_train_endpt\MAN\GT\3A_endpt.wav	mfctrain\3_44.mfc
wav\isolated_digits_ti_train_endpt\MAN\GT\3B_endpt.wav	mfctrain\3_45.mfc
wav\isolated_digits_ti_train_endpt\MAN\GT\4A_endpt.wav	mfctrain\4_44.mfc
wav\isolated_digits_ti_train_endpt\MAN\GT\4B_endpt.wav	mfctrain\4_45.mfc
wav\isolated_digits_ti_train_endpt\MAN\GT\5A_endpt.wav	mfctrain\5_44.mfc
wav\isolated_digits_ti_train_endpt\MAN\GT\5B_endpt.wav	mfctrain\5_45.mfc
wav\isolated_digits_ti_train_endpt\MAN\GT\6A_endpt.wav	mfctrain\6_44.mfc
wav\isolated_digits_ti_train_endpt\MAN\GT\6B_endpt.wav	mfctrain\6_45.mfc
wav\isolated_digits_ti_train_endpt\MAN\GT\7A_endpt.wav	mfctrain\7_44.mfc
wav\isolated_digits_ti_train_endpt\MAN\GT\7B_endpt.wav	mfctrain\7_45.mfc
wav\isolated_digits_ti_train_endpt\MAN\GT\8A_endpt.wav	mfctrain\8_44.mfc
wav\isolated_digits_ti_train_endpt\MAN\GT\8B_endpt.wav	mfctrain\8_45.mfc
wav\isolated_digits_ti_train_endpt\MAN\GT\9A_endpt.wav	mfctrain\9_44.mfc
wav\isolated_digits_ti_train_endpt\MAN\GT\9B_endpt.wav	mfctrain\9_45.mfc
wav\isolated_digits_ti_train_endpt\MAN\GT\OA_endpt.wav	mfctrain\10_44.mfc
wav\isolated_digits_ti_train_endpt\MAN\GT\OB_endpt.wav	mfctrain\10_45.mfc
wav\isolated_digits_ti_train_endpt\MAN\GT\ZA_endpt.wav	mfctrain\0_44.mfc
wav\isolated_digits_ti_train_endpt\MAN\GT\ZB_endpt.wav	mfctrain\0_45.mfc
wav\isolated_digits_ti_train_endpt\MAN\HA\1A_endpt.wav	mfctrain\1_46.mfc
wav\isolated_digits_ti_train_endpt\MAN\HA\1B_endpt.wav	mfctrain\1_47.mfc
wav\isolated_digits_ti_train_endpt\MAN\HA\2A_endpt.wav	mfctrain\2_46.mfc
wav\isolated_digits_ti_train_endpt\MAN\HA\2B_endpt.wav	mfctrain\2_47.mfc
wav\isolated_digits_ti_train_endpt\MAN\HA\3A_endpt.wav	mfctrain\3_46.mfc
wav\isolated_digits_ti_train_endpt\MAN\HA\3B_endpt.wav	mfctrain\3_47.mfc
wav\isolated_digits_ti_train_endpt\MAN\HA\4A_endpt.wav	mfctrain\4_46.mfc
wav\isolated_digits_ti_train_endpt\MAN\HA\4B_endpt.wav	mfctrain\4_47.mfc
wav\isolated_digits_ti_train_endpt\MAN\HA\5A_endpt.wav	mfctrain\5_46.mfc
wav\isolated_digits_ti_train_endpt\MAN\HA\5B_endpt.wav	mfctrain\5_47.mfc
wav\isolated_digits_ti_train_endpt\MAN\HA\6A_endpt.wav	mfctrain\6_46.mfc
wav\isolated_digits_ti_train_endpt\MAN\HA\6B_endpt.wav	mfctrain\6_47.mfc
wav\isolated_digits_ti_train_endpt\MAN\HA\7A_endpt.wav	mfctrain\7_46.mfc
wav\isolated_digits_ti_train_endpt\MAN\HA\7B_endpt.wav	mfctrain\7_47.mfc
wav\isolated_digits_ti_train_endpt\MAN\HA\8A_endpt.wav	mfctrain\8_46.mfc
wav\isolated_digits_ti_train_endpt\MAN\HA\8B_endpt.wav	mfctrain\8_47.mfc
wav\isolated_digits_ti_train_endpt\MAN\HA\9A_endpt.wav	mfctrain\9_46.mfc
wav\isolated_digits_ti_train_endpt\MAN\HA\9B_endpt.wav	mfctrain\9_47.mfc
wav\isolated_digits_ti_train_endpt\MAN\HA\OA_endpt.wav	mfctrain\10_46.mfc
wav\isolated_digits_ti_train_endpt\MAN\HA\OB_endpt.wav	mfctrain\10_47.mfc
wav\isolated_digits_ti_train_endpt\MAN\HA\ZA_endpt.wav	mfctrain\0_46.mfc
wav\isolated_digits_ti_train_endpt\MAN\HA\ZB_endpt.wav	mfctrain\0_47.mfc
wav\isolated_digits_ti_train_endpt\MAN\HH\1A_endpt.wav	mfctrain\1_48.mfc
wav\isolated_digits_ti_train_endpt\MAN\HH\1B_endpt.wav	mfctrain\1_49.mfc
wav\isolated_digits_ti_train_endpt\MAN\HH\2A_endpt.wav	mfctrain\2_48.mfc
wav\isolated_digits_ti_train_endpt\MAN\HH\2B_endpt.wav	mfctrain\2_49.mfc
wav\isolated_digits_ti_train_endpt\MAN\HH\3A_endpt.wav	mfctrain\3_48.mfc
wav\isolated_digits_ti_train_endpt\MAN\HH\3B_endpt.wav	mfctrain\3_49.mfc
wav\isolated_digits_ti_train_endpt\MAN\HH\4A_endpt.wav	mfctrain\4_48.mfc
wav\isolated_digits_ti_train_endpt\MAN\HH\4B_endpt.wav	mfctrain\4_49.mfc
wav\isolated_digits_ti_train_endpt\MAN\HH\5A_endpt.wav	mfctrain\5_48.mfc
wav\isolated_digits_ti_train_endpt\MAN\HH\5B_endpt.wav	mfctrain\5_49.mfc
wav\isolated_digits_ti_train_endpt\MAN\HH\6A_endpt.wav	mfctrain\6_48.mfc
wav\isolated_digits_ti_train_endpt\MAN\HH\6B_endpt.wav	mfctrain\6_49.mfc
wav\isolated_digits_ti_train_endpt\MAN\HH\7A_endpt.wav	mfctrain\7_48.mfc
wav\isolated_digits_ti_train_endpt\MAN\HH\7B_endpt.wav	mfctrain\7_49.mfc
wav\isolated_digits_ti_train_endpt\MAN\HH\8A_endpt.wav	mfctrain\8_48.mfc
wav\isolated_digits_ti_train_endpt\MAN\HH\8B_endpt.wav	mfctrain\8_49.mfc
wav\isolated_digits_ti_train_endpt\MAN\HH\9A_endpt.wav	mfctrain\9_48.mfc
wav\isolated_digits_ti_train_endpt\MAN\HH\9B_endpt.wav	mfctrain\9_49.mfc
wav\isolated_digits_ti_train_endpt\MAN\HH\OA_endpt.wav	mfctrain\10_48.mfc
wav\isolated_digits_ti_train_endpt\MAN\HH\OB_endpt.wav	mfctrain\10_49.mfc
wav\isolated_digits_ti_train_endpt\MAN\HH\ZA_endpt.wav	mfctrain\0_48.mfc
wav\isolated_digits_ti_train_endpt\MAN\HH\ZB_endpt.wav	mfctrain\0_49.mfc
wav\isolated_digits_ti_train_endpt\MAN\HL\1A_endpt.wav	mfctrain\1_50.mfc
wav\isolated_digits_ti_train_endpt\MAN\HL\1B_endpt.wav	mfctrain\1_51.mfc
wav\isolated_digits_ti_train_endpt\MAN\HL\2A_endpt.wav	mfctrain\2_50.mfc
wav\isolated_digits_ti_train_endpt\MAN\HL\2B_endpt.wav	mfctrain\2_51.mfc
wav\isolated_digits_ti_train_endpt\MAN\HL\3A_endpt.wav	mfctrain\3_50.mfc
wav\isolated_digits_ti_train_endpt\MAN\HL\3B_endpt.wav	mfctrain\3_51.mfc
wav\isolated_digits_ti_train_endpt\MAN\HL\4A_endpt.wav	mfctrain\4_50.mfc
wav\isolated_digits_ti_train_endpt\MAN\HL\4B_endpt.wav	mfctrain\4_51.mfc
wav\isolated_digits_ti_train_endpt\MAN\HL\5A_endpt.wav	mfctrain\5_50.mfc
wav\isolated_digits_ti_train_endpt\MAN\HL\5B_endpt.wav	mfctrain\5_51.mfc
wav\isolated_digits_ti_train_endpt\MAN\HL\6A_endpt.wav	mfctrain\6_50.mfc
wav\isolated_digits_ti_train_endpt\MAN\HL\6B_endpt.wav	mfctrain\6_51.mfc
wav\isolated_digits_ti_train_endpt\MAN\HL\7A_endpt.wav	mfctrain\7_50.mfc
wav\isolated_digits_ti_train_endpt\MAN\HL\7B_endpt.wav	mfctrain\7_51.mfc
wav\isolated_digits_ti_train_endpt\MAN\HL\8A_endpt.wav	mfctrain\8_50.mfc
wav\isolated_digits_ti_train_endpt\MAN\HL\8B_endpt.wav	mfctrain\8_51.mfc
wav\isolated_digits_ti_train_endpt\MAN\HL\9A_endpt.wav	mfctrain\9_50.mfc
wav\isolated_digits_ti_train_endpt\MAN\HL\9B_endpt.wav	mfctrain\9_51.mfc
wav\isolated_digits_ti_train_endpt\MAN\HL\OA_endpt.wav	mfctrain\10_50.mfc
wav\isolated_digits_ti_train_endpt\MAN\HL\OB_endpt.wav	mfctrain\10_51.mfc
wav\isolated_digits_ti_train_endpt\MAN\HL\ZA_endpt.wav	mfctrain\0_50.mfc
wav\isolated_digits_ti_train_endpt\MAN\HL\ZB_endpt.wav	mfctrain\0_51.mfc
wav\isolated_digits_ti_train_endpt\MAN\HN\1A_endpt.wav	mfctrain\1_52.mfc
wav\isolated_digits_ti_train_endpt\MAN\HN\1B_endpt.wav	mfctrain\1_53.mfc
wav\isolated_digits_ti_train_endpt\MAN\HN\2A_endpt.wav	mfctrain\2_52.mfc
wav\isolated_digits_ti_train_endpt\MAN\HN\2B_endpt.wav	mfctrain\2_53.mfc
wav\isolated_digits_ti_train_endpt\MAN\HN\3A_endpt.wav	mfctrain\3_52.mfc
wav\isolated_digits_ti_train_endpt\MAN\HN\3B_endpt.wav	mfctrain\3_53.mfc
wav\isolated_digits_ti_train_endpt\MAN\HN\4A_endpt.wav	mfctrain\4_52.mfc
wav\isolated_digits_ti_train_endpt\MAN\HN\4B_endpt.wav	mfctrain\4_53.mfc
wav\isolated_digits_ti_train_endpt\MAN\HN\5A_endpt.wav	mfctrain\5_52.mfc
wav\isolated_digits_ti_train_endpt\MAN\HN\5B_endpt.wav	mfctrain\5_53.mfc
wav\isolated_digits_ti_train_endpt\MAN\HN\6A_endpt.wav	mfctrain\6_52.mfc
wav\isolated_digits_ti_train_endpt\MAN\HN\6B_endpt.wav	mfctrain\6_53.mfc
wav\isolated_digits_ti_train_endpt\MAN\HN\7A_endpt.wav	mfctrain\7_52.mfc
wav\isolated_digits_ti_train_endpt\MAN\HN\7B_endpt.wav	mfctrain\7_53.mfc
wav\isolated_digits_ti_train_endpt\MAN\HN\8A_endpt.wav	mfctrain\8_52.mfc
wav\isolated_digits_ti_train_endpt\MAN\HN\8B_endpt.wav	mfctrain\8_53.mfc
wav\isolated_digits_ti_train_endpt\MAN\HN\9A_endpt.wav	mfctrain\9_52.mfc
wav\isolated_digits_ti_train_endpt\MAN\HN\9B_endpt.wav	mfctrain\9_53.mfc
wav\isolated_digits_ti_train_endpt\MAN\HN\OA_endpt.wav	mfctrain\10_52.mfc
wav\isolated_digits_ti_train_endpt\MAN\HN\OB_endpt.wav	mfctrain\10_53.mfc
wav\isolated_digits_ti_train_endpt\MAN\HN\ZA_endpt.wav	mfctrain\0_52.mfc
wav\isolated_digits_ti_train_endpt\MAN\HN\ZB_endpt.wav	mfctrain\0_53.mfc
wav\isolated_digits_ti_train_endpt\MAN\HS\1A_endpt.wav	mfctrain\1_54.mfc
wav\isolated_digits_ti_train_endpt\MAN\HS\1B_endpt.wav	mfctrain\1_55.mfc
wav\isolated_digits_ti_train_endpt\MAN\HS\2A_endpt.wav	mfctrain\2_54.mfc
wav\isolated_digits_ti_train_endpt\MAN\HS\2B_endpt.wav	mfctrain\2_55.mfc
wav\isolated_digits_ti_train_endpt\MAN\HS\3A_endpt.wav	mfctrain\3_54.mfc
wav\isolated_digits_ti_train_endpt\MAN\HS\3B_endpt.wav	mfctrain\3_55.mfc
wav\isolated_digits_ti_train_endpt\MAN\HS\4A_endpt.wav	mfctrain\4_54.mfc
wav\isolated_digits_ti_train_endpt\MAN\HS\4B_endpt.wav	mfctrain\4_55.mfc
wav\isolated_digits_ti_train_endpt\MAN\HS\5A_endpt.wav	mfctrain\5_54.mfc
wav\isolated_digits_ti_train_endpt\MAN\HS\5B_endpt.wav	mfctrain\5_55.mfc
wav\isolated_digits_ti_train_endpt\MAN\HS\6A_endpt.wav	mfctrain\6_54.mfc
wav\isolated_digits_ti_train_endpt\MAN\HS\6B_endpt.wav	mfctrain\6_55.mfc
wav\isolated_digits_ti_train_endpt\MAN\HS\7A_endpt.wav	mfctrain\7_54.mfc
wav\isolated_digits_ti_train_endpt\MAN\HS\7B_endpt.wav	mfctrain\7_55.mfc
wav\isolated_digits_ti_train_endpt\MAN\HS\8A_endpt.wav	mfctrain\8_54.mfc
wav\isolated_digits_ti_train_endpt\MAN\HS\8B_endpt.wav	mfctrain\8_55.mfc
wav\isolated_digits_ti_train_endpt\MAN\HS\9A_endpt.wav	mfctrain\9_54.mfc
wav\isolated_digits_ti_train_endpt\MAN\HS\9B_endpt.wav	mfctrain\9_55.mfc
wav\isolated_digits_ti_train_endpt\MAN\HS\OA_endpt.wav	mfctrain\10_54.mfc
wav\isolated_digits_ti_train_endpt\MAN\HS\OB_endpt.wav	mfctrain\10_55.mfc
wav\isolated_digits_ti_train_endpt\MAN\HS\ZA_endpt.wav	mfctrain\0_54.mfc
wav\isolated_digits_ti_train_endpt\MAN\HS\ZB_endpt.wav	mfctrain\0_55.mfc
wav\isolated_digits_ti_train_endpt\MAN\IE\1A_endpt.wav	mfctrain\1_56.mfc
wav\isolated_digits_ti_train_endpt\MAN\IE\1B_endpt.wav	mfctrain\1_57.mfc
wav\isolated_digits_ti_train_endpt\MAN\IE\2A_endpt.wav	mfctrain\2_56.mfc
wav\isolated_digits_ti_train_endpt\MAN\IE\2B_endpt.wav	mfctrain\2_57.mfc
wav\isolated_digits_ti_train_endpt\MAN\IE\3A_endpt.wav	mfctrain\3_56.mfc
wav\isolated_digits_ti_train_endpt\MAN\IE\3B_endpt.wav	mfctrain\3_57.mfc
wav\isolated_digits_ti_train_endpt\MAN\IE\4A_endpt.wav	mfctrain\4_56.mfc
wav\isolated_digits_ti_train_endpt\MAN\IE\4B_endpt.wav	mfctrain\4_57.mfc
wav\isolated_digits_ti_train_endpt\MAN\IE\5A_endpt.wav	mfctrain\5_56.mfc
wav\isolated_digits_ti_train_endpt\MAN\IE\5B_endpt.wav	mfctrain\5_57.mfc
wav\isolated_digits_ti_train_endpt\MAN\IE\6A_endpt.wav	mfctrain\6_56.mfc
wav\isolated_digits_ti_train_endpt\MAN\IE\6B_endpt.wav	mfctrain\6_57.mfc
wav\isolated_digits_ti_train_endpt\MAN\IE\7A_endpt.wav	mfctrain\7_56.mfc
wav\isolated_digits_ti_train_endpt\MAN\IE\7B_endpt.wav	mfctrain\7_57.mfc
wav\isolated_digits_ti_train_endpt\MAN\IE\8A_endpt.wav	mfctrain\8_56.mfc
wav\isolated_digits_ti_train_endpt\MAN\IE\8B_endpt.wav	mfctrain\8_57.mfc
wav\isolated_digits_ti_train_endpt\MAN\IE\9A_endpt.wav	mfctrain\9_56.mfc
wav\isolated_digits_ti_train_endpt\MAN\IE\9B_endpt.wav	mfctrain\9_57.mfc
wav\isolated_digits_ti_train_endpt\MAN\IE\OA_endpt.wav	mfctrain\10_56.mfc
wav\isolated_digits_ti_train_endpt\MAN\IE\OB_endpt.wav	mfctrain\10_57.mfc
wav\isolated_digits_ti_train_endpt\MAN\IE\ZA_endpt.wav	mfctrain\0_56.mfc
wav\isolated_digits_ti_train_endpt\MAN\IE\ZB_endpt.wav	mfctrain\0_57.mfc
wav\isolated_digits_ti_train_endpt\MAN\IF\1A_endpt.wav	mfctrain\1_58.mfc
wav\isolated_digits_ti_train_endpt\MAN\IF\1B_endpt.wav	mfctrain\1_59.mfc
wav\isolated_digits_ti_train_endpt\MAN\IF\2A_endpt.wav	mfctrain\2_58.mfc
wav\isolated_digits_ti_train_endpt\MAN\IF\2B_endpt.wav	mfctrain\2_59.mfc
wav\isolated_digits_ti_train_endpt\MAN\IF\3A_endpt.wav	mfctrain\3_58.mfc
wav\isolated_digits_ti_train_endpt\MAN\IF\3B_endpt.wav	mfctrain\3_59.mfc
wav\isolated_digits_ti_train_endpt\MAN\IF\4A_endpt.wav	mfctrain\4_58.mfc
wav\isolated_digits_ti_train_endpt\MAN\IF\4B_endpt.wav	mfctrain\4_59.mfc
wav\isolated_digits_ti_train_endpt\MAN\IF\5A_endpt.wav	mfctrain\5_58.mfc
wav\isolated_digits_ti_train_endpt\MAN\IF\5B_endpt.wav	mfctrain\5_59.mfc
wav\isolated_digits_ti_train_endpt\MAN\IF\6A_endpt.wav	mfctrain\6_58.mfc
wav\isolated_digits_ti_train_endpt\MAN\IF\6B_endpt.wav	mfctrain\6_59.mfc
wav\isolated_digits_ti_train_endpt\MAN\IF\7A_endpt.wav	mfctrain\7_58.mfc
wav\isolated_digits_ti_train_endpt\MAN\IF\7B_endpt.wav	mfctrain\7_59.mfc
wav\isolated_digits_ti_train_endpt\MAN\IF\8A_endpt.wav	mfctrain\8_58.mfc
wav\isolated_digits_ti_train_endpt\MAN\IF\8B_endpt.wav	mfctrain\8_59.mfc
wav\isolated_digits_ti_train_endpt\MAN\IF\9A_endpt.wav	mfctrain\9_58.mfc
wav\isolated_digits_ti_train_endpt\MAN\IF\9B_endpt.wav	mfctrain\9_59.mfc
wav\isolated_digits_ti_train_endpt\MAN\IF\OA_endpt.wav	mfctrain\10_58.mfc
wav\isolated_digits_ti_train_endpt\MAN\IF\OB_endpt.wav	mfctrain\10_59.mfc
wav\isolated_digits_ti_train_endpt\MAN\IF\ZA_endpt.wav	mfctrain\0_58.mfc
wav\isolated_digits_ti_train_endpt\MAN\IF\ZB_endpt.wav	mfctrain\0_59.mfc
wav\isolated_digits_ti_train_endpt\MAN\IN\1A_endpt.wav	mfctrain\1_60.mfc
wav\isolated_digits_ti_train_endpt\MAN\IN\1B_endpt.wav	mfctrain\1_61.mfc
wav\isolated_digits_ti_train_endpt\MAN\IN\2A_endpt.wav	mfctrain\2_60.mfc
wav\isolated_digits_ti_train_endpt\MAN\IN\2B_endpt.wav	mfctrain\2_61.mfc
wav\isolated_digits_ti_train_endpt\MAN\IN\3A_endpt.wav	mfctrain\3_60.mfc
wav\isolated_digits_ti_train_endpt\MAN\IN\3B_endpt.wav	mfctrain\3_61.mfc
wav\isolated_digits_ti_train_endpt\MAN\IN\4A_endpt.wav	mfctrain\4_60.mfc
wav\isolated_digits_ti_train_endpt\MAN\IN\4B_endpt.wav	mfctrain\4_61.mfc
wav\isolated_digits_ti_train_endpt\MAN\IN\5A_endpt.wav	mfctrain\5_60.mfc
wav\isolated_digits_ti_train_endpt\MAN\IN\5B_endpt.wav	mfctrain\5_61.mfc
wav\isolated_digits_ti_train_endpt\MAN\IN\6A_endpt.wav	mfctrain\6_60.mfc
wav\isolated_digits_ti_train_endpt\MAN\IN\6B_endpt.wav	mfctrain\6_61.mfc
wav\isolated_digits_ti_train_endpt\MAN\IN\7A_endpt.wav	mfctrain\7_60.mfc
wav\isolated_digits_ti_train_endpt\MAN\IN\7B_endpt.wav	mfctrain\7_61.mfc
wav\isolated_digits_ti_train_endpt\MAN\IN\8A_endpt.wav	mfctrain\8_60.mfc
wav\isolated_digits_ti_train_endpt\MAN\IN\8B_endpt.wav	mfctrain\8_61.mfc
wav\isolated_digits_ti_train_endpt\MAN\IN\9A_endpt.wav	mfctrain\9_60.mfc
wav\isolated_digits_ti_train_endpt\MAN\IN\9B_endpt.wav	mfctrain\9_61.mfc
wav\isolated_digits_ti_train_endpt\MAN\IN\OA_endpt.wav	mfctrain\10_60.mfc
wav\isolated_digits_ti_train_endpt\MAN\IN\OB_endpt.wav	mfctrain\10_61.mfc
wav\isolated_digits_ti_train_endpt\MAN\IN\ZA_endpt.wav	mfctrain\0_60.mfc
wav\isolated_digits_ti_train_endpt\MAN\IN\ZB_endpt.wav	mfctrain\0_61.mfc
wav\isolated_digits_ti_train_endpt\MAN\IT\1A_endpt.wav	mfctrain\1_62.mfc
wav\isolated_digits_ti_train_endpt\MAN\IT\1B_endpt.wav	mfctrain\1_63.mfc
wav\isolated_digits_ti_train_endpt\MAN\IT\2A_endpt.wav	mfctrain\2_62.mfc
wav\isolated_digits_ti_train_endpt\MAN\IT\2B_endpt.wav	mfctrain\2_63.mfc
wav\isolated_digits_ti_train_endpt\MAN\IT\3A_endpt.wav	mfctrain\3_62.mfc
wav\isolated_digits_ti_train_endpt\MAN\IT\3B_endpt.wav	mfctrain\3_63.mfc
wav\isolated_digits_ti_train_endpt\MAN\IT\4A_endpt.wav	mfctrain\4_62.mfc
wav\isolated_digits_ti_train_endpt\MAN\IT\4B_endpt.wav	mfctrain\4_63.mfc
wav\isolated_digits_ti_train_endpt\MAN\IT\5A_endpt.wav	mfctrain\5_62.mfc
wav\isolated_digits_ti_train_endpt\MAN\IT\5B_endpt.wav	mfctrain\5_63.mfc
wav\isolated_digits_ti_train_endpt\MAN\IT\6A_endpt.wav	mfctrain\6_62.mfc
wav\isolated_digits_ti_train_endpt\MAN\IT\6B_endpt.wav	mfctrain\6_63.mfc
wav\isolated_digits_ti_train_endpt\MAN\IT\7A_endpt.wav	mfctrain\7_62.mfc
wav\isolated_digits_ti_train_endpt\MAN\IT\7B_endpt.wav	mfctrain\7_63.mfc
wav\isolated_digits_ti_train_endpt\MAN\IT\8A_endpt.wav	mfctrain\8_62.mfc
wav\isolated_digits_ti_train_endpt\MAN\IT\8B_endpt.wav	mfctrain\8_63.mfc
wav\isolated_digits_ti_train_endpt\MAN\IT\9A_endpt.wav	mfctrain\9_62.mfc
wav\isolated_digits_ti_train_endpt\MAN\IT\9B_endpt.wav	mfctrain\9_63.mfc
wav\isolated_digits_ti_train_endpt\MAN\IT\OA_endpt.wav	mfctrain\10_62.mfc
wav\isolated_digits_ti_train_endpt\MAN\IT\OB_endpt.wav	mfctrain\10_63.mfc
wav\isolated_digits_ti_train_endpt\MAN\IT\ZA_endpt.wav	mfctrain\0_62.mfc
wav\isolated_digits_ti_train_endpt\MAN\IT\ZB_endpt.wav	mfctrain\0_63.mfc
wav\isolated_digits_ti_train_endpt\MAN\JR\1A_endpt.wav	mfctrain\1_64.mfc
wav\isolated_digits_ti_train_endpt\MAN\JR\1B_endpt.wav	mfctrain\1_65.mfc
wav\isolated_digits_ti_train_endpt\MAN\JR\2A_endpt.wav	mfctrain\2_64.mfc
wav\isolated_digits_ti_train_endpt\MAN\JR\2B_endpt.wav	mfctrain\2_65.mfc
wav\isolated_digits_ti_train_endpt\MAN\JR\3A_endpt.wav	mfctrain\3_64.mfc
wav\isolated_digits_ti_train_endpt\MAN\JR\3B_endpt.wav	mfctrain\3_65.mfc
wav\isolated_digits_ti_train_endpt\MAN\JR\4A_endpt.wav	mfctrain\4_64.mfc
wav\isolated_digits_ti_train_endpt\MAN\JR\4B_endpt.wav	mfctrain\4_65.mfc
wav\isolated_digits_ti_train_endpt\MAN\JR\5A_endpt.wav	mfctrain\5_64.mfc
wav\isolated_digits_ti_train_endpt\MAN\JR\5B_endpt.wav	mfctrain\5_65.mfc
wav\isolated_digits_ti_train_endpt\MAN\JR\6A_endpt.wav	mfctrain\6_64.mfc
wav\isolated_digits_ti_train_endpt\MAN\JR\6B_endpt.wav	mfctrain\6_65.mfc
wav\isolated_digits_ti_train_endpt\MAN\JR\7A_endpt.wav	mfctrain\7_64.mfc
wav\isolated_digits_ti_train_endpt\MAN\JR\7B_endpt.wav	mfctrain\7_65.mfc
wav\isolated_digits_ti_train_endpt\MAN\JR\8A_endpt.wav	mfctrain\8_64.mfc
wav\isolated_digits_ti_train_endpt\MAN\JR\8B_endpt.wav	mfctrain\8_65.mfc
wav\isolated_digits_ti_train_endpt\MAN\JR\9A_endpt.wav	mfctrain\9_64.mfc
wav\isolated_digits_ti_train_endpt\MAN\JR\9B_endpt.wav	mfctrain\9_65.mfc
wav\isolated_digits_ti_train_endpt\MAN\JR\OA_endpt.wav	mfctrain\10_64.mfc
wav\isolated_digits_ti_train_endpt\MAN\JR\OB_endpt.wav	mfctrain\10_65.mfc
wav\isolated_digits_ti_train_endpt\MAN\JR\ZA_endpt.wav	mfctrain\0_64.mfc
wav\isolated_digits_ti_train_endpt\MAN\JR\ZB_endpt.wav	mfctrain\0_65.mfc
wav\isolated_digits_ti_train_endpt\MAN\JT\1A_endpt.wav	mfctrain\1_66.mfc
wav\isolated_digits_ti_train_endpt\MAN\JT\1B_endpt.wav	mfctrain\1_67.mfc
wav\isolated_digits_ti_train_endpt\MAN\JT\2A_endpt.wav	mfctrain\2_66.mfc
wav\isolated_digits_ti_train_endpt\MAN\JT\2B_endpt.wav	mfctrain\2_67.mfc
wav\isolated_digits_ti_train_endpt\MAN\JT\3A_endpt.wav	mfctrain\3_66.mfc
wav\isolated_digits_ti_train_endpt\MAN\JT\3B_endpt.wav	mfctrain\3_67.mfc
wav\isolated_digits_ti_train_endpt\MAN\JT\4A_endpt.wav	mfctrain\4_66.mfc
wav\isolated_digits_ti_train_endpt\MAN\JT\4B_endpt.wav	mfctrain\4_67.mfc
wav\isolated_digits_ti_train_endpt\MAN\JT\5A_endpt.wav	mfctrain\5_66.mfc
wav\isolated_digits_ti_train_endpt\MAN\JT\5B_endpt.wav	mfctrain\5_67.mfc
wav\isolated_digits_ti_train_endpt\MAN\JT\6A_endpt.wav	mfctrain\6_66.mfc
wav\isolated_digits_ti_train_endpt\MAN\JT\6B_endpt.wav	mfctrain\6_67.mfc
wav\isolated_digits_ti_train_endpt\MAN\JT\7A_endpt.wav	mfctrain\7_66.mfc
wav\isolated_digits_ti_train_endpt\MAN\JT\7B_endpt.wav	mfctrain\7_67.mfc
wav\isolated_digits_ti_train_endpt\MAN\JT\8A_endpt.wav	mfctrain\8_66.mfc
wav\isolated_digits_ti_train_endpt\MAN\JT\8B_endpt.wav	mfctrain\8_67.mfc
wav\isolated_digits_ti_train_endpt\MAN\JT\9A_endpt.wav	mfctrain\9_66.mfc
wav\isolated_digits_ti_train_endpt\MAN\JT\9B_endpt.wav	mfctrain\9_67.mfc
wav\isolated_digits_ti_train_endpt\MAN\JT\OA_endpt.wav	mfctrain\10_66.mfc
wav\isolated_digits_ti_train_endpt\MAN\JT\OB_endpt.wav	mfctrain\10_67.mfc
wav\isolated_digits_ti_train_endpt\MAN\JT\ZA_endpt.wav	mfctrain\0_66.mfc
wav\isolated_digits_ti_train_endpt\MAN\JT\ZB_endpt.wav	mfctrain\0_67.mfc
wav\isolated_digits_ti_train_endpt\MAN\KD\1A_endpt.wav	mfctrain\1_68.mfc
wav\isolated_digits_ti_train_endpt\MAN\KD\1B_endpt.wav	mfctrain\1_69.mfc
wav\isolated_digits_ti_train_endpt\MAN\KD\2A_endpt.wav	mfctrain\2_68.mfc
wav\isolated_digits_ti_train_endpt\MAN\KD\2B_endpt.wav	mfctrain\2_69.mfc
wav\isolated_digits_ti_train_endpt\MAN\KD\3A_endpt.wav	mfctrain\3_68.mfc
wav\isolated_digits_ti_train_endpt\MAN\KD\3B_endpt.wav	mfctrain\3_69.mfc
wav\isolated_digits_ti_train_endpt\MAN\KD\4A_endpt.wav	mfctrain\4_68.mfc
wav\isolated_digits_ti_train_endpt\MAN\KD\4B_endpt.wav	mfctrain\4_69.mfc
wav\isolated_digits_ti_train_endpt\MAN\KD\5A_endpt.wav	mfctrain\5_68.mfc
wav\isolated_digits_ti_train_endpt\MAN\KD\5B_endpt.wav	mfctrain\5_69.mfc
wav\isolated_digits_ti_train_endpt\MAN\KD\6A_endpt.wav	mfctrain\6_68.mfc
wav\isolated_digits_ti_train_endpt\MAN\KD\6B_endpt.wav	mfctrain\6_69.mfc
wav\isolated_digits_ti_train_endpt\MAN\KD\7A_endpt.wav	mfctrain\7_68.mfc
wav\isolated_digits_ti_train_endpt\MAN\KD\7B_endpt.wav	mfctrain\7_69.mfc
wav\isolated_digits_ti_train_endpt\MAN\KD\8A_endpt.wav	mfctrain\8_68.mfc
wav\isolated_digits_ti_train_endpt\MAN\KD\8B_endpt.wav	mfctrain\8_69.mfc
wav\isolated_digits_ti_train_endpt\MAN\KD\9A_endpt.wav	mfctrain\9_68.mfc
wav\isolated_digits_ti_train_endpt\MAN\KD\9B_endpt.wav	mfctrain\9_69.mfc
wav\isolated_digits_ti_train_endpt\MAN\KD\OA_endpt.wav	mfctrain\10_68.mfc
wav\isolated_digits_ti_train_endpt\MAN\KD\OB_endpt.wav	mfctrain\10_69.mfc
wav\isolated_digits_ti_train_endpt\MAN\KD\ZA_endpt.wav	mfctrain\0_68.mfc
wav\isolated_digits_ti_train_endpt\MAN\KD\ZB_endpt.wav	mfctrain\0_69.mfc
wav\isolated_digits_ti_train_endpt\MAN\KP\1A_endpt.wav	mfctrain\1_70.mfc
wav\isolated_digits_ti_train_endpt\MAN\KP\1B_endpt.wav	mfctrain\1_71.mfc
wav\isolated_digits_ti_train_endpt\MAN\KP\2A_endpt.wav	mfctrain\2_70.mfc
wav\isolated_digits_ti_train_endpt\MAN\KP\2B_endpt.wav	mfctrain\2_71.mfc
wav\isolated_digits_ti_train_endpt\MAN\KP\3A_endpt.wav	mfctrain\3_70.mfc
wav\isolated_digits_ti_train_endpt\MAN\KP\3B_endpt.wav	mfctrain\3_71.mfc
wav\isolated_digits_ti_train_endpt\MAN\KP\4A_endpt.wav	mfctrain\4_70.mfc
wav\isolated_digits_ti_train_endpt\MAN\KP\4B_endpt.wav	mfctrain\4_71.mfc
wav\isolated_digits_ti_train_endpt\MAN\KP\5A_endpt.wav	mfctrain\5_70.mfc
wav\isolated_digits_ti_train_endpt\MAN\KP\5B_endpt.wav	mfctrain\5_71.mfc
wav\isolated_digits_ti_train_endpt\MAN\KP\6A_endpt.wav	mfctrain\6_70.mfc
wav\isolated_digits_ti_train_endpt\MAN\KP\6B_endpt.wav	mfctrain\6_71.mfc
wav\isolated_digits_ti_train_endpt\MAN\KP\7A_endpt.wav	mfctrain\7_70.mfc
wav\isolated_digits_ti_train_endpt\MAN\KP\7B_endpt.wav	mfctrain\7_71.mfc
wav\isolated_digits_ti_train_endpt\MAN\KP\8A_endpt.wav	mfctrain\8_70.mfc
wav\isolated_digits_ti_train_endpt\MAN\KP\8B_endpt.wav	mfctrain\8_71.mfc
wav\isolated_digits_ti_train_endpt\MAN\KP\9A_endpt.wav	mfctrain\9_70.mfc
wav\isolated_digits_ti_train_endpt\MAN\KP\9B_endpt.wav	mfctrain\9_71.mfc
wav\isolated_digits_ti_train_endpt\MAN\KP\OA_endpt.wav	mfctrain\10_70.mfc
wav\isolated_digits_ti_train_endpt\MAN\KP\OB_endpt.wav	mfctrain\10_71.mfc
wav\isolated_digits_ti_train_endpt\MAN\KP\ZA_endpt.wav	mfctrain\0_70.mfc
wav\isolated_digits_ti_train_endpt\MAN\KP\ZB_endpt.wav	mfctrain\0_71.mfc
wav\isolated_digits_ti_train_endpt\MAN\KR\1A_endpt.wav	mfctrain\1_72.mfc
wav\isolated_digits_ti_train_endpt\MAN\KR\1B_endpt.wav	mfctrain\1_73.mfc
wav\isolated_digits_ti_train_endpt\MAN\KR\2A_endpt.wav	mfctrain\2_72.mfc
wav\isolated_digits_ti_train_endpt\MAN\KR\2B_endpt.wav	mfctrain\2_73.mfc
wav\isolated_digits_ti_train_endpt\MAN\KR\3A_endpt.wav	mfctrain\3_72.mfc
wav\isolated_digits_ti_train_endpt\MAN\KR\3B_endpt.wav	mfctrain\3_73.mfc
wav\isolated_digits_ti_train_endpt\MAN\KR\4A_endpt.wav	mfctrain\4_72.mfc
wav\isolated_digits_ti_train_endpt\MAN\KR\4B_endpt.wav	mfctrain\4_73.mfc
wav\isolated_digits_ti_train_endpt\MAN\KR\5A_endpt.wav	mfctrain\5_72.mfc
wav\isolated_digits_ti_train_endpt\MAN\KR\5B_endpt.wav	mfctrain\5_73.mfc
wav\isolated_digits_ti_train_endpt\MAN\KR\6A_endpt.wav	mfctrain\6_72.mfc
wav\isolated_digits_ti_train_endpt\MAN\KR\6B_endpt.wav	mfctrain\6_73.mfc
wav\isolated_digits_ti_train_endpt\MAN\KR\7A_endpt.wav	mfctrain\7_72.mfc
wav\isolated_digits_ti_train_endpt\MAN\KR\7B_endpt.wav	mfctrain\7_73.mfc
wav\isolated_digits_ti_train_endpt\MAN\KR\8A_endpt.wav	mfctrain\8_72.mfc
wav\isolated_digits_ti_train_endpt\MAN\KR\8B_endpt.wav	mfctrain\8_73.mfc
wav\isolated_digits_ti_train_endpt\MAN\KR\9A_endpt.wav	mfctrain\9_72.mfc
wav\isolated_digits_ti_train_endpt\MAN\KR\9B_endpt.wav	mfctrain\9_73.mfc
wav\isolated_digits_ti_train_endpt\MAN\KR\OA_endpt.wav	mfctrain\10_72.mfc
wav\isolated_digits_ti_train_endpt\MAN\KR\OB_endpt.wav	mfctrain\10_73.mfc
wav\isolated_digits_ti_train_endpt\MAN\KR\ZA_endpt.wav	mfctrain\0_72.mfc
wav\isolated_digits_ti_train_endpt\MAN\KR\ZB_endpt.wav	mfctrain\0_73.mfc
wav\isolated_digits_ti_train_endpt\MAN\LH\1A_endpt.wav	mfctrain\1_74.mfc
wav\isolated_digits_ti_train_endpt\MAN\LH\1B_endpt.wav	mfctrain\1_75.mfc
wav\isolated_digits_ti_train_endpt\MAN\LH\2A_endpt.wav	mfctrain\2_74.mfc
wav\isolated_digits_ti_train_endpt\MAN\LH\2B_endpt.wav	mfctrain\2_75.mfc
wav\isolated_digits_ti_train_endpt\WOMAN\AC\1A_endpt.wav	mfctrain\1_76.mfc
wav\isolated_digits_ti_train_endpt\WOMAN\AC\1B_endpt.wav	mfctrain\1_77.mfc
wav\isolated_digits_ti_train_endpt\WOMAN\AC\2A_endpt.wav	mfctrain\2_76.mfc
wav\isolated_digits_ti_train_endpt\WOMAN\AC\2B_endpt.wav	mfctrain\2_77.mfc
wav\isolated_digits_ti_train_endpt\WOMAN\AC\3A_endpt.wav	mfctrain\3_74.mfc
wav\isolated_digits_ti_train_endpt\WOMAN\AC\3B_endpt.wav	mfctrain\3_75.mfc
wav\isolated_digits_ti_train_endpt\WOMAN\AC\4A_endpt.wav	mfctrain\4_74.mfc
wav\isolated_digits_ti_train_endpt\WOMAN\AC\4B_endpt.wav	mfctrain\4_75.mfc
wav\isolated_digits_ti_train_endpt\WOMAN\AC\5A_endpt.wav	mfctrain\5_74.mfc
wav\isolated_digits_ti_train_endpt\WOMAN\AC\5B_endpt.wav	mfctrain\5_75.mfc
wav\isolated_digits_ti_train_endpt\WOMAN\AC\6A_endpt.wav	mfctrain\6_74.mfc
wav\isolated_digits_ti_train_endpt\WOMAN\AC\6B_endpt.wav	mfctrain\6_75.mfc
wav\isolated_digits_ti_train_endpt\WOMAN\AC\7A_endpt.wav	mfctrain\7_74.mfc
wav\isolated_digits_ti_train_endpt\WOMAN\AC\7B_endpt.wav	mfctrain\7_75.mfc
wav\isolated_digits_ti_train_endpt\WOMAN\AC\8A_endpt.wav	mfctrain\8_74.mfc
wav\isolated_digits_ti_train_endpt\WOMAN\AC\8B_endpt.wav	mfctrain\8_75.mfc
wav\isolated_digits_ti_train_endpt\WOMAN\AC\9A_endpt.wav	mfctrain\9_74.mfc
wav\isolated_digits_ti_train_endpt\WOMAN\AC\9B_endpt.wav	mfctrain\9_75.mfc
wav\isolated_digits_ti_train_endpt\WOMAN\AC\OA_endpt.wav	mfctrain\10_74.mfc
wav\isolated_digits_ti_train_endpt\WOMAN\AC\OB_endpt.wav	mfctrain\10_75.mfc
wav\isolated_digits_ti_train_endpt\WOMAN\AC\ZA_endpt.wav	mfctrain\0_74.mfc
wav\isolated_digits_ti_train_endpt\WOMAN\AC\ZB_endpt.wav	mfctrain\0_75.mfc
wav\isolated_digits_ti_train_endpt\WOMAN\AG\1A_endpt.wav	mfctrain\1_78.mfc
wav\isolated_digits_ti_train_endpt\WOMAN\AG\1B_endpt.wav	mfctrain\1_79.mfc
wav\isolated_digits_ti_train_endpt\WOMAN\AG\2A_endpt.wav	mfctrain\2_78.mfc
wav\isolated_digits_ti_train_endpt\WOMAN\AG\2B_endpt.wav	mfctrain\2_79.mfc
wav\isolated_digits_ti_train_endpt\WOMAN\AG\3A_endpt.wav	mfctrain\3_76.mfc
wav\isolated_digits_ti_train_endpt\WOMAN\AG\3B_endpt.wav	mfctrain\3_77.mfc
wav\isolated_digits_ti_train_endpt\WOMAN\AG\4A_endpt.wav	mfctrain\4_76.mfc
wav\isolated_digits_ti_train_endpt\WOMAN\AG\4B_endpt.wav	mfctrain\4_77.mfc
wav\isolated_digits_ti_train_endpt\WOMAN\AG\5A_endpt.wav	mfctrain\5_76.mfc
wav\isolated_digits_ti_train_endpt\WOMAN\AG\5B_endpt.wav	mfctrain\5_77.mfc
wav\isolated_digits_ti_train_endpt\WOMAN\AG\6A_endpt.wav	mfctrain\6_76.mfc
wav\isolated_digits_ti_train_endpt\WOMAN\AG\6B_endpt.wav	mfctrain\6_77.mfc
wav\isolated_digits_ti_train_endpt\WOMAN\AG\7A_endpt.wav	mfctrain\7_76.mfc
wav\isolated_digits_ti_train_endpt\WOMAN\AG\7B_endpt.wav	mfctrain\7_77.mfc
wav\isolated_digits_ti_train_endpt\WOMAN\AG\8A_endpt.wav	mfctrain\8_76.mfc
wav\isolated_digits_ti_train_endpt\WOMAN\AG\8B_endpt.wav	mfctrain\8_77.mfc
wav\isolated_digits_ti_train_endpt\WOMAN\AG\9A_endpt.wav	mfctrain\9_76.mfc
wav\isolated_digits_ti_train_endpt\WOMAN\AG\9B_endpt.wav	mfctrain\9_77.mfc
wav\isolated_digits_ti_train_endpt\WOMAN\AG\OA_endpt.wav	mfctrain\10_76.mfc
wav\isolated_digits_ti_train_endpt\WOMAN\AG\OB_endpt.wav	mfctrain\10_77.mfc
wav\isolated_digits_ti_train_endpt\WOMAN\AG\ZA_endpt.wav	mfctrain\0_76.mfc
wav\isolated_digits_ti_train_endpt\WOMAN\AG\ZB_endpt.wav	mfctrain\0_77.mfc
wav\isolated_digits_ti_train_endpt\WOMAN\AI\1A_endpt.wav	mfctrain\1_80.mfc
wav\isolated_digits_ti_train_endpt\WOMAN\AI\1B_endpt.wav	mfctrain\1_81.mfc
wav\isolated_digits_ti_train_endpt\WOMAN\AI\2A_endpt.wav	mfctrain\2_80.mfc
wav\isolated_digits_ti_train_endpt\WOMAN\AI\2B_endpt.wav	mfctrain\2_81.mfc
wav\isolated_digits_ti_train_endpt\WOMAN\AI\3A_endpt.wav	mfctrain\3_78.mfc
wav\isolated_digits_ti_train_endpt\WOMAN\AI\3B_endpt.wav	mfctrain\3_79.mfc
wav\isolated_digits_ti_train_endpt\WOMAN\AI\4A_endpt.wav	mfctrain\4_78.mfc
wav\isolated_digits_ti_train_endpt\WOMAN\AI\4B_endpt.wav	mfctrain\4_79.mfc
wav\isolated_digits_ti_train_endpt\WOMAN\AI\5A_endpt.wav	mfctrain\5_78.mfc
wav\isolated_digits_ti_train_endpt\WOMAN\AI\5B_endpt.wav	mfctrain\5_79.mfc
wav\isolated_digits_ti_train_endpt\WOMAN\AI\6A_endpt.wav	mfctrain\6_78.mfc
wav\isolated_digits_ti_train_endpt\WOMAN\AI\6B_endpt.wav	mfctrain\6_79.mfc
wav\isolated_digits_ti_train_endpt\WOMAN\AI\7A_endpt.wav	mfctrain\7_78.mfc
wav\isolated_digits_ti_train_endpt\WOMAN\AI\7B_endpt.wav	mfctrain\7_79.mfc
wav\isolated_digits_ti_train_endpt\WOMAN\AI\8A_endpt.wav	mfctrain\8_78.mfc
wav\isolated_digits_ti_train_endpt\WOMAN\AI\8B_endpt.wav	mfctrain\8_79.mfc
wav\isolated_digits_ti_train_endpt\WOMAN\AI\9A_endpt.wav	mfctrain\9_78.mfc
wav\isolated_digits_ti_train_endpt\WOMAN\AI\9B_endpt.wav	mfctrain\9_79.mfc
wav\isolated_digits_ti_train_endpt\WOMAN\AI\OA_endpt.wav	mfctrain\10_78.mfc
wav\isolated_digits_ti_train_endpt\WOMAN\AI\OB_endpt.wav	mfctrain\10_79.mfc
wav\isolated_digits_ti_train_endpt\WOMAN\AI\ZA_endpt.wav	mfctrain\0_78.mfc
wav\isolated_digits_ti_train_endpt\WOMAN\AI\ZB_endpt.wav	mfctrain\0_79.mfc
wav\isolated_digits_ti_train_endpt\WOMAN\AN\1A_endpt.wav	mfctrain\1_82.mfc
wav\isolated_digits_ti_train_endpt\WOMAN\AN\1B_endpt.wav	mfctrain\1_83.mfc
wav\isolated_digits_ti_train_endpt\WOMAN\AN\2A_endpt.wav	mfctrain\2_82.mfc
wav\isolated_digits_ti_train_endpt\WOMAN\AN\2B_endpt.wav	mfctrain\2_83.mfc
wav\isolated_digits_ti_train_endpt\WOMAN\AN\3A_endpt.wav	mfctrain\3_80.mfc
wav\isolated_digits_ti_train_endpt\WOMAN\AN\3B_endpt.wav	mfctrain\3_81.mfc
wav\isolated_digits_ti_train_endpt\WOMAN\AN\4A_endpt.wav	mfctrain\4_80.mfc
wav\isolated_digits_ti_train_endpt\WOMAN\AN\4B_endpt.wav	mfctrain\4_81.mfc
wav\isolated_digits_ti_train_endpt\WOMAN\AN\5A_endpt.wav	mfctrain\5_80.mfc
wav\isolated_digits_ti_train_endpt\WOMAN\AN\5B_endpt.wav	mfctrain\5_81.mfc
wav\isolated_digits_ti_train_endpt\WOMAN\AN\6A_endpt.wav	mfctrain\6_80.mfc
wav\isolated_digits_ti_train_endpt\WOMAN\AN\6B_endpt.wav	mfctrain\6_81.mfc
wav\isolated_digits_ti_train_endpt\WOMAN\AN\7A_endpt.wav	mfctrain\7_80.mfc
wav\isolated_digits_ti_train_endpt\WOMAN\AN\7B_endpt.wav	mfctrain\7_81.mfc
wav\isolated_digits_ti_train_endpt\WOMAN\AN\8A_endpt.wav	mfctrain\8_80.mfc
wav\isolated_digits_ti_train_endpt\WOMAN\AN\8B_endpt.wav	mfctrain\8_81.mfc
wav\isolated_digits_ti_train_endpt\WOMAN\AN\9A_endpt.wav	mfctrain\9_80.mfc
wav\isolated_digits_ti_train_endpt\WOMAN\AN\9B_endpt.wav	mfctrain\9_81.mfc
wav\isolated_digits_ti_train_endpt\WOMAN\AN\OA_endpt.wav	mfctrain\10_80.mfc
wav\isolated_digits_ti_train_endpt\WOMAN\AN\OB_endpt.wav	mfctrain\10_81.mfc
wav\isolated_digits_ti_train_endpt\WOMAN\AN\ZA_endpt.wav	mfctrain\0_80.mfc
wav\isolated_digits_ti_train_endpt\WOMAN\AN\ZB_endpt.wav	mfctrain\0_81.mfc
wav\isolated_digits_ti_train_endpt\WOMAN\BH\1A_endpt.wav	mfctrain\1_84.mfc
wav\isolated_digits_ti_train_endpt\WOMAN\BH\1B_endpt.wav	mfctrain\1_85.mfc
wav\isolated_digits_ti_train_endpt\WOMAN\BH\2A_endpt.wav	mfctrain\2_84.mfc
wav\isolated_digits_ti_train_endpt\WOMAN\BH\2B_endpt.wav	mfctrain\2_85.mfc
wav\isolated_digits_ti_train_endpt\WOMAN\BH\3A_endpt.wav	mfctrain\3_82.mfc
wav\isolated_digits_ti_train_endpt\WOMAN\BH\3B_endpt.wav	mfctrain\3_83.mfc
wav\isolated_digits_ti_train_endpt\WOMAN\BH\4A_endpt.wav	mfctrain\4_82.mfc
wav\isolated_digits_ti_train_endpt\WOMAN\BH\4B_endpt.wav	mfctrain\4_83.mfc
wav\isolated_digits_ti_train_endpt\WOMAN\BH\5A_endpt.wav	mfctrain\5_82.mfc
wav\isolated_digits_ti_train_endpt\WOMAN\BH\5B_endpt.wav	mfctrain\5_83.mfc
wav\isolated_digits_ti_train_endpt\WOMAN\BH\6A_endpt.wav	mfctrain\6_82.mfc
wav\isolated_digits_ti_train_endpt\WOMAN\BH\6B_endpt.wav	mfctrain\6_83.mfc
wav\isolated_digits_ti_train_endpt\WOMAN\BH\7A_endpt.wav	mfctrain\7_82.mfc
wav\isolated_digits_ti_train_endpt\WOMAN\BH\7B_endpt.wav	mfctrain\7_83.mfc
wav\isolated_digits_ti_train_endpt\WOMAN\BH\8A_endpt.wav	mfctrain\8_82.mfc
wav\isolated_digits_ti_train_endpt\WOMAN\BH\8B_endpt.wav	mfctrain\8_83.mfc
wav\isolated_digits_ti_train_endpt\WOMAN\BH\9A_endpt.wav	mfctrain\9_82.mfc
wav\isolated_digits_ti_train_endpt\WOMAN\BH\9B_endpt.wav	mfctrain\9_83.mfc
wav\isolated_digits_ti_train_endpt\WOMAN\BH\OA_endpt.wav	mfctrain\10_82.mfc
wav\isolated_digits_ti_train_endpt\WOMAN\BH\OB_endpt.wav	mfctrain\10_83.mfc
wav\isolated_digits_ti_train_endpt\WOMAN\BH\ZA_endpt.wav	mfctrain\0_82.mfc
wav\isolated_digits_ti_train_endpt\WOMAN\BH\ZB_endpt.wav	mfctrain\0_83.mfc
wav\isolated_digits_ti_train_endpt\WOMAN\BI\1A_endpt.wav	mfctrain\1_86.mfc
wav\isolated_digits_ti_train_endpt\WOMAN\BI\1B_endpt.wav	mfctrain\1_87.mfc
wav\isolated_digits_ti_train_endpt\WOMAN\BI\2A_endpt.wav	mfctrain\2_86.mfc
wav\isolated_digits_ti_train_endpt\WOMAN\BI\2B_endpt.wav	mfctrain\2_87.mfc
wav\isolated_digits_ti_train_endpt\WOMAN\BI\3A_endpt.wav	mfctrain\3_84.mfc
wav\isolated_digits_ti_train_endpt\WOMAN\BI\3B_endpt.wav	mfctrain\3_85.mfc
wav\isolated_digits_ti_train_endpt\WOMAN\BI\4A_endpt.wav	mfctrain\4_84.mfc
wav\isolated_digits_ti_train_endpt\WOMAN\BI\4B_endpt.wav	mfctrain\4_85.mfc
wav\isolated_digits_ti_train_endpt\WOMAN\BI\5A_endpt.wav	mfctrain\5_84.mfc
wav\isolated_digits_ti_train_endpt\WOMAN\BI\5B_endpt.wav	mfctrain\5_85.mfc
wav\isolated_digits_ti_train_endpt\WOMAN\BI\6A_endpt.wav	mfctrain\6_84.mfc
wav\isolated_digits_ti_train_endpt\WOMAN\BI\6B_endpt.wav	mfctrain\6_85.mfc
wav\isolated_digits_ti_train_endpt\WOMAN\BI\7A_endpt.wav	mfctrain\7_84.mfc
wav\isolated_digits_ti_train_endpt\WOMAN\BI\7B_endpt.wav	mfctrain\7_85.mfc
wav\isolated_digits_ti_train_endpt\WOMAN\BI\8A_endpt.wav	mfctrain\8_84.mfc
wav\isolated_digits_ti_train_endpt\WOMAN\BI\8B_endpt.wav	mfctrain\8_85.mfc
wav\isolated_digits_ti_train_endpt\WOMAN\BI\9A_endpt.wav	mfctrain\9_84.mfc
wav\isolated_digits_ti_train_endpt\WOMAN\BI\9B_endpt.wav	mfctrain\9_85.mfc
wav\isolated_digits_ti_train_endpt\WOMAN\BI\OA_endpt.wav	mfctrain\10_84.mfc
wav\isolated_digits_ti_train_endpt\WOMAN\BI\OB_endpt.wav	mfctrain\10_85.mfc
wav\isolated_digits_ti_train_endpt\WOMAN\BI\ZA_endpt.wav	mfctrain\0_84.mfc
wav\isolated_digits_ti_train_endpt\WOMAN\BI\ZB_endpt.wav	mfctrain\0_85.mfc
wav\isolated_digits_ti_train_endpt\WOMAN\BR\1A_endpt.wav	mfctrain\1_88.mfc
wav\isolated_digits_ti_train_endpt\WOMAN\BR\1B_endpt.wav	mfctrain\1_89.mfc
wav\isolated_digits_ti_train_endpt\WOMAN\BR\2A_endpt.wav	mfctrain\2_88.mfc
wav\isolated_digits_ti_train_endpt\WOMAN\BR\2B_endpt.wav	mfctrain\2_89.mfc
wav\isolated_digits_ti_train_endpt\WOMAN\BR\3A_endpt.wav	mfctrain\3_86.mfc
wav\isolated_digits_ti_train_endpt\WOMAN\BR\3B_endpt.wav	mfctrain\3_87.mfc
wav\isolated_digits_ti_train_endpt\WOMAN\BR\4A_endpt.wav	mfctrain\4_86.mfc
wav\isolated_digits_ti_train_endpt\WOMAN\BR\4B_endpt.wav	mfctrain\4_87.mfc
wav\isolated_digits_ti_train_endpt\WOMAN\BR\5A_endpt.wav	mfctrain\5_86.mfc
wav\isolated_digits_ti_train_endpt\WOMAN\BR\5B_endpt.wav	mfctrain\5_87.mfc
wav\isolated_digits_ti_train_endpt\WOMAN\BR\6A_endpt.wav	mfctrain\6_86.mfc
wav\isolated_digits_ti_train_endpt\WOMAN\BR\6B_endpt.wav	mfctrain\6_87.mfc
wav\isolated_digits_ti_train_endpt\WOMAN\BR\7A_endpt.wav	mfctrain\7_86.mfc
wav\isolated_digits_ti_train_endpt\WOMAN\BR\7B_endpt.wav	mfctrain\7_87.mfc
wav\isolated_digits_ti_train_endpt\WOMAN\BR\8A_endpt.wav	mfctrain\8_86.mfc
wav\isolated_digits_ti_train_endpt\WOMAN\BR\8B_endpt.wav	mfctrain\8_87.mfc
wav\isolated_digits_ti_train_endpt\WOMAN\BR\9A_endpt.wav	mfctrain\9_86.mfc
wav\isolated_digits_ti_train_endpt\WOMAN\BR\9B_endpt.wav	mfctrain\9_87.mfc
wav\isolated_digits_ti_train_endpt\WOMAN\BR\OA_endpt.wav	mfctrain\10_86.mfc
wav\isolated_digits_ti_train_endpt\WOMAN\BR\OB_endpt.wav	mfctrain\10_87.mfc
wav\isolated_digits_ti_train_endpt\WOMAN\BR\ZA_endpt.wav	mfctrain\0_86.mfc
wav\isolated_digits_ti_train_endpt\WOMAN\BR\ZB_endpt.wav	mfctrain\0_87.mfc
wav\isolated_digits_ti_train_endpt\WOMAN\CA\1A_endpt.wav	mfctrain\1_90.mfc
wav\isolated_digits_ti_train_endpt\WOMAN\CA\1B_endpt.wav	mfctrain\1_91.mfc
wav\isolated_digits_ti_train_endpt\WOMAN\CA\2A_endpt.wav	mfctrain\2_90.mfc
wav\isolated_digits_ti_train_endpt\WOMAN\CA\2B_endpt.wav	mfctrain\2_91.mfc
wav\isolated_digits_ti_train_endpt\WOMAN\CA\3A_endpt.wav	mfctrain\3_88.mfc
wav\isolated_digits_ti_train_endpt\WOMAN\CA\3B_endpt.wav	mfctrain\3_89.mfc
wav\isolated_digits_ti_train_endpt\WOMAN\CA\4A_endpt.wav	mfctrain\4_88.mfc
wav\isolated_digits_ti_train_endpt\WOMAN\CA\4B_endpt.wav	mfctrain\4_89.mfc
wav\isolated_digits_ti_train_endpt\WOMAN\CA\5A_endpt.wav	mfctrain\5_88.mfc
wav\isolated_digits_ti_train_endpt\WOMAN\CA\5B_endpt.wav	mfctrain\5_89.mfc
wav\isolated_digits_ti_train_endpt\WOMAN\CA\6A_endpt.wav	mfctrain\6_88.mfc
wav\isolated_digits_ti_train_endpt\WOMAN\CA\6B_endpt.wav	mfctrain\6_89.mfc
wav\isolated_digits_ti_train_endpt\WOMAN\CA\7A_endpt.wav	mfctrain\7_88.mfc
wav\isolated_digits_ti_train_endpt\WOMAN\CA\7B_endpt.wav	mfctrain\7_89.mfc
wav\isolated_digits_ti_train_endpt\WOMAN\CA\8A_endpt.wav	mfctrain\8_88.mfc
wav\isolated_digits_ti_train_endpt\WOMAN\CA\8B_endpt.wav	mfctrain\8_89.mfc
wav\isolated_digits_ti_train_endpt\WOMAN\CA\9A_endpt.wav	mfctrain\9_88.mfc
wav\isolated_digits_ti_train_endpt\WOMAN\CA\9B_endpt.wav	mfctrain\9_89.mfc
wav\isolated_digits_ti_train_endpt\WOMAN\CA\OA_endpt.wav	mfctrain\10_88.mfc
wav\isolated_digits_ti_train_endpt\WOMAN\CA\OB_endpt.wav	mfctrain\10_89.mfc
wav\isolated_digits_ti_train_endpt\WOMAN\CA\ZA_endpt.wav	mfctrain\0_88.mfc
wav\isolated_digits_ti_train_endpt\WOMAN\CA\ZB_endpt.wav	mfctrain\0_89.mfc
wav\isolated_digits_ti_train_endpt\WOMAN\CG\1A_endpt.wav	mfctrain\1_92.mfc
wav\isolated_digits_ti_train_endpt\WOMAN\CG\1B_endpt.wav	mfctrain\1_93.mfc
wav\isolated_digits_ti_train_endpt\WOMAN\CG\2A_endpt.wav	mfctrain\2_92.mfc
wav\isolated_digits_ti_train_endpt\WOMAN\CG\2B_endpt.wav	mfctrain\2_93.mfc
wav\isolated_digits_ti_train_endpt\WOMAN\CG\3A_endpt.wav	mfctrain\3_90.mfc
wav\isolated_digits_ti_train_endpt\WOMAN\CG\3B_endpt.wav	mfctrain\3_91.mfc
wav\isolated_digits_ti_train_endpt\WOMAN\CG\4A_endpt.wav	mfctrain\4_90.mfc
wav\isolated_digits_ti_train_endpt\WOMAN\CG\4B_endpt.wav	mfctrain\4_91.mfc
wav\isolated_digits_ti_train_endpt\WOMAN\CG\5A_endpt.wav	mfctrain\5_90.mfc
wav\isolated_digits_ti_train_endpt\WOMAN\CG\5B_endpt.wav	mfctrain\5_91.mfc
wav\isolated_digits_ti_train_endpt\WOMAN\CG\6A_endpt.wav	mfctrain\6_90.mfc
wav\isolated_digits_ti_train_endpt\WOMAN\CG\6B_endpt.wav	mfctrain\6_91.mfc
wav\isolated_digits_ti_train_endpt\WOMAN\CG\7A_endpt.wav	mfctrain\7_90.mfc
wav\isolated_digits_ti_train_endpt\WOMAN\CG\7B_endpt.wav	mfctrain\7_91.mfc
wav\isolated_digits_ti_train_endpt\WOMAN\CG\8A_endpt.wav	mfctrain\8_90.mfc
wav\isolated_digits_ti_train_endpt\WOMAN\CG\8B_endpt.wav	mfctrain\8_91.mfc
wav\isolated_digits_ti_train_endpt\WOMAN\CG\9A_endpt.wav	mfctrain\9_90.mfc
wav\isolated_digits_ti_train_endpt\WOMAN\CG\9B_endpt.wav	mfctrain\9_91.mfc
wav\isolated_digits_ti_train_endpt\WOMAN\CG\OA_endpt.wav	mfctrain\10_90.mfc
wav\isolated_digits_ti_train_endpt\WOMAN\CG\OB_endpt.wav	mfctrain\10_91.mfc
wav\isolated_digits_ti_train_endpt\WOMAN\CG\ZA_endpt.wav	mfctrain\0_90.mfc
wav\isolated_digits_ti_train_endpt\WOMAN\CG\ZB_endpt.wav	mfctrain\0_91.mfc
wav\isolated_digits_ti_train_endpt\WOMAN\CL\1A_endpt.wav	mfctrain\1_94.mfc
wav\isolated_digits_ti_train_endpt\WOMAN\CL\1B_endpt.wav	mfctrain\1_95.mfc
wav\isolated_digits_ti_train_endpt\WOMAN\CL\2A_endpt.wav	mfctrain\2_94.mfc
wav\isolated_digits_ti_train_endpt\WOMAN\CL\2B_endpt.wav	mfctrain\2_95.mfc
wav\isolated_digits_ti_train_endpt\WOMAN\CL\3A_endpt.wav	mfctrain\3_92.mfc
wav\isolated_digits_ti_train_endpt\WOMAN\CL\3B_endpt.wav	mfctrain\3_93.mfc
wav\isolated_digits_ti_train_endpt\WOMAN\CL\4A_endpt.wav	mfctrain\4_92.mfc
wav\isolated_digits_ti_train_endpt\WOMAN\CL\4B_endpt.wav	mfctrain\4_93.mfc
wav\isolated_digits_ti_train_endpt\WOMAN\CL\5A_endpt.wav	mfctrain\5_92.mfc
wav\isolated_digits_ti_train_endpt\WOMAN\CL\5B_endpt.wav	mfctrain\5_93.mfc
wav\isolated_digits_ti_train_endpt\WOMAN\CL\6A_endpt.wav	mfctrain\6_92.mfc
wav\isolated_digits_ti_train_endpt\WOMAN\CL\6B_endpt.wav	mfctrain\6_93.mfc
wav\isolated_digits_ti_train_endpt\WOMAN\CL\7A_endpt.wav	mfctrain\7_92.mfc
wav\isolated_digits_ti_train_endpt\WOMAN\CL\7B_endpt.wav	mfctrain\7_93.mfc
wav\isolated_digits_ti_train_endpt\WOMAN\CL\8A_endpt.wav	mfctrain\8_92.mfc
wav\isolated_digits_ti_train_endpt\WOMAN\CL\8B_endpt.wav	mfctrain\8_93.mfc
wav\isolated_digits_ti_train_endpt\WOMAN\CL\9A_endpt.wav	mfctrain\9_92.mfc
wav\isolated_digits_ti_train_endpt\WOMAN\CL\9B_endpt.wav	mfctrain\9_93.mfc
wav\isolated_digits_ti_train_endpt\WOMAN\CL\OA_endpt.wav	mfctrain\10_92.mfc
wav\isolated_digits_ti_train_endpt\WOMAN\CL\OB_endpt.wav	mfctrain\10_93.mfc
wav\isolated_digits_ti_train_endpt\WOMAN\CL\ZA_endpt.wav	mfctrain\0_92.mfc
wav\isolated_digits_ti_train_endpt\WOMAN\CL\ZB_endpt.wav	mfctrain\0_93.mfc
wav\isolated_digits_ti_train_endpt\WOMAN\CM\1A_endpt.wav	mfctrain\1_96.mfc
wav\isolated_digits_ti_train_endpt\WOMAN\CM\1B_endpt.wav	mfctrain\1_97.mfc
wav\isolated_digits_ti_train_endpt\WOMAN\CM\2A_endpt.wav	mfctrain\2_96.mfc
wav\isolated_digits_ti_train_endpt\WOMAN\CM\2B_endpt.wav	mfctrain\2_97.mfc
wav\isolated_digits_ti_train_endpt\WOMAN\CM\3A_endpt.wav	mfctrain\3_94.mfc
wav\isolated_digits_ti_train_endpt\WOMAN\CM\3B_endpt.wav	mfctrain\3_95.mfc
wav\isolated_digits_ti_train_endpt\WOMAN\CM\4A_endpt.wav	mfctrain\4_94.mfc
wav\isolated_digits_ti_train_endpt\WOMAN\CM\4B_endpt.wav	mfctrain\4_95.mfc
wav\isolated_digits_ti_train_endpt\WOMAN\CM\5A_endpt.wav	mfctrain\5_94.mfc
wav\isolated_digits_ti_train_endpt\WOMAN\CM\5B_endpt.wav	mfctrain\5_95.mfc
wav\isolated_digits_ti_train_endpt\WOMAN\CM\6A_endpt.wav	mfctrain\6_94.mfc
wav\isolated_digits_ti_train_endpt\WOMAN\CM\6B_endpt.wav	mfctrain\6_95.mfc
wav\isolated_digits_ti_train_endpt\WOMAN\CM\7A_endpt.wav	mfctrain\7_94.mfc
wav\isolated_digits_ti_train_endpt\WOMAN\CM\7B_endpt.wav	mfctrain\7_95.mfc
wav\isolated_digits_ti_train_endpt\WOMAN\CM\8A_endpt.wav	mfctrain\8_94.mfc
wav\isolated_digits_ti_train_endpt\WOMAN\CM\8B_endpt.wav	mfctrain\8_95.mfc
wav\isolated_digits_ti_train_endpt\WOMAN\CM\9A_endpt.wav	mfctrain\9_94.mfc
wav\isolated_digits_ti_train_endpt\WOMAN\CM\9B_endpt.wav	mfctrain\9_95.mfc
wav\isolated_digits_ti_train_endpt\WOMAN\CM\OA_endpt.wav	mfctrain\10_94.mfc
wav\isolated_digits_ti_train_endpt\WOMAN\CM\OB_endpt.wav	mfctrain\10_95.mfc
wav\isolated_digits_ti_train_endpt\WOMAN\CM\ZA_endpt.wav	mfctrain\0_94.mfc
wav\isolated_digits_ti_train_endpt\WOMAN\CM\ZB_endpt.wav	mfctrain\0_95.mfc
wav\isolated_digits_ti_train_endpt\WOMAN\DC\1A_endpt.wav	mfctrain\1_98.mfc
wav\isolated_digits_ti_train_endpt\WOMAN\DC\1B_endpt.wav	mfctrain\1_99.mfc
wav\isolated_digits_ti_train_endpt\WOMAN\DC\2A_endpt.wav	mfctrain\2_98.mfc
wav\isolated_digits_ti_train_endpt\WOMAN\DC\2B_endpt.wav	mfctrain\2_99.mfc
wav\isolated_digits_ti_train_endpt\WOMAN\DC\3A_endpt.wav	mfctrain\3_96.mfc
wav\isolated_digits_ti_train_endpt\WOMAN\DC\3B_endpt.wav	mfctrain\3_97.mfc
wav\isolated_digits_ti_train_endpt\WOMAN\DC\4A_endpt.wav	mfctrain\4_96.mfc
wav\isolated_digits_ti_train_endpt\WOMAN\DC\4B_endpt.wav	mfctrain\4_97.mfc
wav\isolated_digits_ti_train_endpt\WOMAN\DC\5A_endpt.wav	mfctrain\5_96.mfc
wav\isolated_digits_ti_train_endpt\WOMAN\DC\5B_endpt.wav	mfctrain\5_97.mfc
wav\isolated_digits_ti_train_endpt\WOMAN\DC\6A_endpt.wav	mfctrain\6_96.mfc
wav\isolated_digits_ti_train_endpt\WOMAN\DC\6B_endpt.wav	mfctrain\6_97.mfc
wav\isolated_digits_ti_train_endpt\WOMAN\DC\7A_endpt.wav	mfctrain\7_96.mfc
wav\isolated_digits_ti_train_endpt\WOMAN\DC\7B_endpt.wav	mfctrain\7_97.mfc
wav\isolated_digits_ti_train_endpt\WOMAN\DC\8A_endpt.wav	mfctrain\8_96.mfc
wav\isolated_digits_ti_train_endpt\WOMAN\DC\8B_endpt.wav	mfctrain\8_97.mfc
wav\isolated_digits_ti_train_endpt\WOMAN\DC\9A_endpt.wav	mfctrain\9_96.mfc
wav\isolated_digits_ti_train_endpt\WOMAN\DC\9B_endpt.wav	mfctrain\9_97.mfc
wav\isolated_digits_ti_train_endpt\WOMAN\DC\OA_endpt.wav	mfctrain\10_96.mfc
wav\isolated_digits_ti_train_endpt\WOMAN\DC\OB_endpt.wav	mfctrain\10_97.mfc
wav\isolated_digits_ti_train_endpt\WOMAN\DC\ZA_endpt.wav	mfctrain\0_96.mfc
wav\isolated_digits_ti_train_endpt\WOMAN\DC\ZB_endpt.wav	mfctrain\0_97.mfc
wav\isolated_digits_ti_train_endpt\WOMAN\DG\1A_endpt.wav	mfctrain\1_100.mfc
wav\isolated_digits_ti_train_endpt\WOMAN\DG\1B_endpt.wav	mfctrain\1_101.mfc
wav\isolated_digits_ti_train_endpt\WOMAN\DG\2A_endpt.wav	mfctrain\2_100.mfc
wav\isolated_digits_ti_train_endpt\WOMAN\DG\2B_endpt.wav	mfctrain\2_101.mfc
wav\isolated_digits_ti_train_endpt\WOMAN\DG\3A_endpt.wav	mfctrain\3_98.mfc
wav\isolated_digits_ti_train_endpt\WOMAN\DG\3B_endpt.wav	mfctrain\3_99.mfc
wav\isolated_digits_ti_train_endpt\WOMAN\DG\4A_endpt.wav	mfctrain\4_98.mfc
wav\isolated_digits_ti_train_endpt\WOMAN\DG\4B_endpt.wav	mfctrain\4_99.mfc
wav\isolated_digits_ti_train_endpt\WOMAN\DG\5A_endpt.wav	mfctrain\5_98.mfc
wav\isolated_digits_ti_train_endpt\WOMAN\DG\5B_endpt.wav	mfctrain\5_99.mfc
wav\isolated_digits_ti_train_endpt\WOMAN\DG\6A_endpt.wav	mfctrain\6_98.mfc
wav\isolated_digits_ti_train_endpt\WOMAN\DG\6B_endpt.wav	mfctrain\6_99.mfc
wav\isolated_digits_ti_train_endpt\WOMAN\DG\7A_endpt.wav	mfctrain\7_98.mfc
wav\isolated_digits_ti_train_endpt\WOMAN\DG\7B_endpt.wav	mfctrain\7_99.mfc
wav\isolated_digits_ti_train_endpt\WOMAN\DG\8A_endpt.wav	mfctrain\8_98.mfc
wav\isolated_digits_ti_train_endpt\WOMAN\DG\8B_endpt.wav	mfctrain\8_99.mfc
wav\isolated_digits_ti_train_endpt\WOMAN\DG\9A_endpt.wav	mfctrain\9_98.mfc
wav\isolated_digits_ti_train_endpt\WOMAN\DG\9B_endpt.wav	mfctrain\9_99.mfc
wav\isolated_digits_ti_train_endpt\WOMAN\DG\OA_endpt.wav	mfctrain\10_98.mfc
wav\isolated_digits_ti_train_endpt\WOMAN\DG\OB_endpt.wav	mfctrain\10_99.mfc
wav\isolated_digits_ti_train_endpt\WOMAN\DG\ZA_endpt.wav	mfctrain\0_98.mfc
wav\isolated_digits_ti_train_endpt\WOMAN\DG\ZB_endpt.wav	mfctrain\0_99.mfc
wav\isolated_digits_ti_train_endpt\WOMAN\EA\1A_endpt.wav	mfctrain\1_102.mfc
wav\isolated_digits_ti_train_endpt\WOMAN\EA\1B_endpt.wav	mfctrain\1_103.mfc
wav\isolated_digits_ti_train_endpt\WOMAN\EA\2A_endpt.wav	mfctrain\2_102.mfc
wav\isolated_digits_ti_train_endpt\WOMAN\EA\2B_endpt.wav	mfctrain\2_103.mfc
wav\isolated_digits_ti_train_endpt\WOMAN\EA\3A_endpt.wav	mfctrain\3_100.mfc
wav\isolated_digits_ti_train_endpt\WOMAN\EA\3B_endpt.wav	mfctrain\3_101.mfc
wav\isolated_digits_ti_train_endpt\WOMAN\EA\4A_endpt.wav	mfctrain\4_100.mfc
wav\isolated_digits_ti_train_endpt\WOMAN\EA\4B_endpt.wav	mfctrain\4_101.mfc
wav\isolated_digits_ti_train_endpt\WOMAN\EA\5A_endpt.wav	mfctrain\5_100.mfc
wav\isolated_digits_ti_train_endpt\WOMAN\EA\5B_endpt.wav	mfctrain\5_101.mfc
wav\isolated_digits_ti_train_endpt\WOMAN\EA\6A_endpt.wav	mfctrain\6_100.mfc
wav\isolated_digits_ti_train_endpt\WOMAN\EA\6B_endpt.wav	mfctrain\6_101.mfc
wav\isolated_digits_ti_train_endpt\WOMAN\EA\7A_endpt.wav	mfctrain\7_100.mfc
wav\isolated_digits_ti_train_endpt\WOMAN\EA\7B_endpt.wav	mfctrain\7_101.mfc
wav\isolated_digits_ti_train_endpt\WOMAN\EA\8A_endpt.wav	mfctrain\8_100.mfc
wav\isolated_digits_ti_train_endpt\WOMAN\EA\8B_endpt.wav	mfctrain\8_101.mfc
wav\isolated_digits_ti_train_endpt\WOMAN\EA\9A_endpt.wav	mfctrain\9_100.mfc
wav\isolated_digits_ti_train_endpt\WOMAN\EA\9B_endpt.wav	mfctrain\9_101.mfc
wav\isolated_digits_ti_train_endpt\WOMAN\EA\OA_endpt.wav	mfctrain\10_100.mfc
wav\isolated_digits_ti_train_endpt\WOMAN\EA\OB_endpt.wav	mfctrain\10_101.mfc
wav\isolated_digits_ti_train_endpt\WOMAN\EA\ZA_endpt.wav	mfctrain\0_100.mfc
wav\isolated_digits_ti_train_endpt\WOMAN\EA\ZB_endpt.wav	mfctrain\0_101.mfc
wav\isolated_digits_ti_train_endpt\WOMAN\EC\1A_endpt.wav	mfctrain\1_104.mfc
wav\isolated_digits_ti_train_endpt\WOMAN\EC\1B_endpt.wav	mfctrain\1_105.mfc
wav\isolated_digits_ti_train_endpt\WOMAN\EC\2A_endpt.wav	mfctrain\2_104.mfc
wav\isolated_digits_ti_train_endpt\WOMAN\EC\2B_endpt.wav	mfctrain\2_105.mfc
wav\isolated_digits_ti_train_endpt\WOMAN\EC\3A_endpt.wav	mfctrain\3_102.mfc
wav\isolated_digits_ti_train_endpt\WOMAN\EC\3B_endpt.wav	mfctrain\3_103.mfc
wav\isolated_digits_ti_train_endpt\WOMAN\EC\4A_endpt.wav	mfctrain\4_102.mfc
wav\isolated_digits_ti_train_endpt\WOMAN\EC\4B_endpt.wav	mfctrain\4_103.mfc
wav\isolated_digits_ti_train_endpt\WOMAN\EC\5A_endpt.wav	mfctrain\5_102.mfc
wav\isolated_digits_ti_train_endpt\WOMAN\EC\5B_endpt.wav	mfctrain\5_103.mfc
wav\isolated_digits_ti_train_endpt\WOMAN\EC\6A_endpt.wav	mfctrain\6_102.mfc
wav\isolated_digits_ti_train_endpt\WOMAN\EC\6B_endpt.wav	mfctrain\6_103.mfc
wav\isolated_digits_ti_train_endpt\WOMAN\EC\7A_endpt.wav	mfctrain\7_102.mfc
wav\isolated_digits_ti_train_endpt\WOMAN\EC\7B_endpt.wav	mfctrain\7_103.mfc
wav\isolated_digits_ti_train_endpt\WOMAN\EC\8A_endpt.wav	mfctrain\8_102.mfc
wav\isolated_digits_ti_train_endpt\WOMAN\EC\8B_endpt.wav	mfctrain\8_103.mfc
wav\isolated_digits_ti_train_endpt\WOMAN\EC\9A_endpt.wav	mfctrain\9_102.mfc
wav\isolated_digits_ti_train_endpt\WOMAN\EC\9B_endpt.wav	mfctrain\9_103.mfc
wav\isolated_digits_ti_train_endpt\WOMAN\EC\OA_endpt.wav	mfctrain\10_102.mfc
wav\isolated_digits_ti_train_endpt\WOMAN\EC\OB_endpt.wav	mfctrain\10_103.mfc
wav\isolated_digits_ti_train_endpt\WOMAN\EC\ZA_endpt.wav	mfctrain\0_102.mfc
wav\isolated_digits_ti_train_endpt\WOMAN\EC\ZB_endpt.wav	mfctrain\0_103.mfc
wav\isolated_digits_ti_train_endpt\WOMAN\EE\1A_endpt.wav	mfctrain\1_106.mfc
wav\isolated_digits_ti_train_endpt\WOMAN\EE\1B_endpt.wav	mfctrain\1_107.mfc
wav\isolated_digits_ti_train_endpt\WOMAN\EE\2A_endpt.wav	mfctrain\2_106.mfc
wav\isolated_digits_ti_train_endpt\WOMAN\EE\2B_endpt.wav	mfctrain\2_107.mfc
wav\isolated_digits_ti_train_endpt\WOMAN\EE\3A_endpt.wav	mfctrain\3_104.mfc
wav\isolated_digits_ti_train_endpt\WOMAN\EE\3B_endpt.wav	mfctrain\3_105.mfc
wav\isolated_digits_ti_train_endpt\WOMAN\EE\4A_endpt.wav	mfctrain\4_104.mfc
wav\isolated_digits_ti_train_endpt\WOMAN\EE\4B_endpt.wav	mfctrain\4_105.mfc
wav\isolated_digits_ti_train_endpt\WOMAN\EE\5A_endpt.wav	mfctrain\5_104.mfc
wav\isolated_digits_ti_train_endpt\WOMAN\EE\5B_endpt.wav	mfctrain\5_105.mfc
wav\isolated_digits_ti_train_endpt\WOMAN\EE\6A_endpt.wav	mfctrain\6_104.mfc
wav\isolated_digits_ti_train_endpt\WOMAN\EE\6B_endpt.wav	mfctrain\6_105.mfc
wav\isolated_digits_ti_train_endpt\WOMAN\EE\7A_endpt.wav	mfctrain\7_104.mfc
wav\isolated_digits_ti_train_endpt\WOMAN\EE\7B_endpt.wav	mfctrain\7_105.mfc
wav\isolated_digits_ti_train_endpt\WOMAN\EE\8A_endpt.wav	mfctrain\8_104.mfc
wav\isolated_digits_ti_train_endpt\WOMAN\EE\8B_endpt.wav	mfctrain\8_105.mfc
wav\isolated_digits_ti_train_endpt\WOMAN\EE\9A_endpt.wav	mfctrain\9_104.mfc
wav\isolated_digits_ti_train_endpt\WOMAN\EE\9B_endpt.wav	mfctrain\9_105.mfc
wav\isolated_digits_ti_train_endpt\WOMAN\EE\OA_endpt.wav	mfctrain\10_104.mfc
wav\isolated_digits_ti_train_endpt\WOMAN\EE\OB_endpt.wav	mfctrain\10_105.mfc
wav\isolated_digits_ti_train_endpt\WOMAN\EE\ZA_endpt.wav	mfctrain\0_104.mfc
wav\isolated_digits_ti_train_endpt\WOMAN\EE\ZB_endpt.wav	mfctrain\0_105.mfc
wav\isolated_digits_ti_train_endpt\WOMAN\EG\1A_endpt.wav	mfctrain\1_108.mfc
wav\isolated_digits_ti_train_endpt\WOMAN\EG\1B_endpt.wav	mfctrain\1_109.mfc
wav\isolated_digits_ti_train_endpt\WOMAN\EG\2A_endpt.wav	mfctrain\2_108.mfc
wav\isolated_digits_ti_train_endpt\WOMAN\EG\2B_endpt.wav	mfctrain\2_109.mfc
wav\isolated_digits_ti_train_endpt\WOMAN\EG\3A_endpt.wav	mfctrain\3_106.mfc
wav\isolated_digits_ti_train_endpt\WOMAN\EG\3B_endpt.wav	mfctrain\3_107.mfc
wav\isolated_digits_ti_train_endpt\WOMAN\EG\4A_endpt.wav	mfctrain\4_106.mfc
wav\isolated_digits_ti_train_endpt\WOMAN\EG\4B_endpt.wav	mfctrain\4_107.mfc
wav\isolated_digits_ti_train_endpt\WOMAN\EG\5A_endpt.wav	mfctrain\5_106.mfc
wav\isolated_digits_ti_train_endpt\WOMAN\EG\5B_endpt.wav	mfctrain\5_107.mfc
wav\isolated_digits_ti_train_endpt\WOMAN\EG\6A_endpt.wav	mfctrain\6_106.mfc
wav\isolated_digits_ti_train_endpt\WOMAN\EG\6B_endpt.wav	mfctrain\6_107.mfc
wav\isolated_digits_ti_train_endpt\WOMAN\EG\7A_endpt.wav	mfctrain\7_106.mfc
wav\isolated_digits_ti_train_endpt\WOMAN\EG\7B_endpt.wav	mfctrain\7_107.mfc
wav\isolated_digits_ti_train_endpt\WOMAN\EG\8A_endpt.wav	mfctrain\8_106.mfc
wav\isolated_digits_ti_train_endpt\WOMAN\EG\8B_endpt.wav	mfctrain\8_107.mfc
wav\isolated_digits_ti_train_endpt\WOMAN\EG\9A_endpt.wav	mfctrain\9_106.mfc
wav\isolated_digits_ti_train_endpt\WOMAN\EG\9B_endpt.wav	mfctrain\9_107.mfc
wav\isolated_digits_ti_train_endpt\WOMAN\EG\OA_endpt.wav	mfctrain\10_106.mfc
wav\isolated_digits_ti_train_endpt\WOMAN\EG\OB_endpt.wav	mfctrain\10_107.mfc
wav\isolated_digits_ti_train_endpt\WOMAN\EG\ZA_endpt.wav	mfctrain\0_106.mfc
wav\isolated_digits_ti_train_endpt\WOMAN\EG\ZB_endpt.wav	mfctrain\0_107.mfc
wav\isolated_digits_ti_train_endpt\WOMAN\EI\1A_endpt.wav	mfctrain\1_110.mfc
wav\isolated_digits_ti_train_endpt\WOMAN\EI\1B_endpt.wav	mfctrain\1_111.mfc
wav\isolated_digits_ti_train_endpt\WOMAN\EI\2A_endpt.wav	mfctrain\2_110.mfc
wav\isolated_digits_ti_train_endpt\WOMAN\EI\2B_endpt.wav	mfctrain\2_111.mfc
wav\isolated_digits_ti_train_endpt\WOMAN\EI\3A_endpt.wav	mfctrain\3_108.mfc
wav\isolated_digits_ti_train_endpt\WOMAN\EI\3B_endpt.wav	mfctrain\3_109.mfc
wav\isolated_digits_ti_train_endpt\WOMAN\EI\4A_endpt.wav	mfctrain\4_108.mfc
wav\isolated_digits_ti_train_endpt\WOMAN\EI\4B_endpt.wav	mfctrain\4_109.mfc
wav\isolated_digits_ti_train_endpt\WOMAN\EI\5A_endpt.wav	mfctrain\5_108.mfc
wav\isolated_digits_ti_train_endpt\WOMAN\EI\5B_endpt.wav	mfctrain\5_109.mfc
wav\isolated_digits_ti_train_endpt\WOMAN\EI\6A_endpt.wav	mfctrain\6_108.mfc
wav\isolated_digits_ti_train_endpt\WOMAN\EI\6B_endpt.wav	mfctrain\6_109.mfc
wav\isolated_digits_ti_train_endpt\WOMAN\EI\7A_endpt.wav	mfctrain\7_108.mfc
wav\isolated_digits_ti_train_endpt\WOMAN\EI\7B_endpt.wav	mfctrain\7_109.mfc
wav\isolated_digits_ti_train_endpt\WOMAN\EI\8A_endpt.wav	mfctrain\8_108.mfc
wav\isolated_digits_ti_train_endpt\WOMAN\EI\8B_endpt.wav	mfctrain\8_109.mfc
wav\isolated_digits_ti_train_endpt\WOMAN\EI\9A_endpt.wav	mfctrain\9_108.mfc
wav\isolated_digits_ti_train_endpt\WOMAN\EI\9B_endpt.wav	mfctrain\9_109.mfc
wav\isolated_digits_ti_train_endpt\WOMAN\EI\OA_endpt.wav	mfctrain\10_108.mfc
wav\isolated_digits_ti_train_endpt\WOMAN\EI\OB_endpt.wav	mfctrain\10_109.mfc
wav\isolated_digits_ti_train_endpt\WOMAN\EI\ZA_endpt.wav	mfctrain\0_108.mfc
wav\isolated_digits_ti_train_endpt\WOMAN\EI\ZB_endpt.wav	mfctrain\0_109.mfc
wav\isolated_digits_ti_train_endpt\WOMAN\EK\1A_endpt.wav	mfctrain\1_112.mfc
wav\isolated_digits_ti_train_endpt\WOMAN\EK\1B_endpt.wav	mfctrain\1_113.mfc
wav\isolated_digits_ti_train_endpt\WOMAN\EK\2A_endpt.wav	mfctrain\2_112.mfc
wav\isolated_digits_ti_train_endpt\WOMAN\EK\2B_endpt.wav	mfctrain\2_113.mfc
wav\isolated_digits_ti_train_endpt\WOMAN\EK\3A_endpt.wav	mfctrain\3_110.mfc
wav\isolated_digits_ti_train_endpt\WOMAN\EK\3B_endpt.wav	mfctrain\3_111.mfc
wav\isolated_digits_ti_train_endpt\WOMAN\EK\4A_endpt.wav	mfctrain\4_110.mfc
wav\isolated_digits_ti_train_endpt\WOMAN\EK\4B_endpt.wav	mfctrain\4_111.mfc
wav\isolated_digits_ti_train_endpt\WOMAN\EK\5A_endpt.wav	mfctrain\5_110.mfc
wav\isolated_digits_ti_train_endpt\WOMAN\EK\5B_endpt.wav	mfctrain\5_111.mfc
wav\isolated_digits_ti_train_endpt\WOMAN\EK\6A_endpt.wav	mfctrain\6_110.mfc
wav\isolated_digits_ti_train_endpt\WOMAN\EK\6B_endpt.wav	mfctrain\6_111.mfc
wav\isolated_digits_ti_train_endpt\WOMAN\EK\7A_endpt.wav	mfctrain\7_110.mfc
wav\isolated_digits_ti_train_endpt\WOMAN\EK\7B_endpt.wav	mfctrain\7_111.mfc
wav\isolated_digits_ti_train_endpt\WOMAN\EK\8A_endpt.wav	mfctrain\8_110.mfc
wav\isolated_digits_ti_train_endpt\WOMAN\EK\8B_endpt.wav	mfctrain\8_111.mfc
wav\isolated_digits_ti_train_endpt\WOMAN\EK\9A_endpt.wav	mfctrain\9_110.mfc
wav\isolated_digits_ti_train_endpt\WOMAN\EK\9B_endpt.wav	mfctrain\9_111.mfc
wav\isolated_digits_ti_train_endpt\WOMAN\EK\OA_endpt.wav	mfctrain\10_110.mfc
wav\isolated_digits_ti_train_endpt\WOMAN\EK\OB_endpt.wav	mfctrain\10_111.mfc
wav\isolated_digits_ti_train_endpt\WOMAN\EK\ZA_endpt.wav	mfctrain\0_110.mfc
wav\isolated_digits_ti_train_endpt\WOMAN\EK\ZB_endpt.wav	mfctrain\0_111.mfc
wav\isolated_digits_ti_train_endpt\WOMAN\ES\1A_endpt.wav	mfctrain\1_114.mfc
wav\isolated_digits_ti_train_endpt\WOMAN\ES\1B_endpt.wav	mfctrain\1_115.mfc
wav\isolated_digits_ti_train_endpt\WOMAN\ES\2A_endpt.wav	mfctrain\2_114.mfc
wav\isolated_digits_ti_train_endpt\WOMAN\ES\2B_endpt.wav	mfctrain\2_115.mfc
wav\isolated_digits_ti_train_endpt\WOMAN\ES\3A_endpt.wav	mfctrain\3_112.mfc
wav\isolated_digits_ti_train_endpt\WOMAN\ES\3B_endpt.wav	mfctrain\3_113.mfc
wav\isolated_digits_ti_train_endpt\WOMAN\ES\4A_endpt.wav	mfctrain\4_112.mfc
wav\isolated_digits_ti_train_endpt\WOMAN\ES\4B_endpt.wav	mfctrain\4_113.mfc
wav\isolated_digits_ti_train_endpt\WOMAN\ES\5A_endpt.wav	mfctrain\5_112.mfc
wav\isolated_digits_ti_train_endpt\WOMAN\ES\5B_endpt.wav	mfctrain\5_113.mfc
wav\isolated_digits_ti_train_endpt\WOMAN\ES\6A_endpt.wav	mfctrain\6_112.mfc
wav\isolated_digits_ti_train_endpt\WOMAN\ES\6B_endpt.wav	mfctrain\6_113.mfc
wav\isolated_digits_ti_train_endpt\WOMAN\ES\7A_endpt.wav	mfctrain\7_112.mfc
wav\isolated_digits_ti_train_endpt\WOMAN\ES\7B_endpt.wav	mfctrain\7_113.mfc
wav\isolated_digits_ti_train_endpt\WOMAN\ES\8A_endpt.wav	mfctrain\8_112.mfc
wav\isolated_digits_ti_train_endpt\WOMAN\ES\8B_endpt.wav	mfctrain\8_113.mfc
wav\isolated_digits_ti_train_endpt\WOMAN\ES\9A_endpt.wav	mfctrain\9_112.mfc
wav\isolated_digits_ti_train_endpt\WOMAN\ES\9B_endpt.wav	mfctrain\9_113.mfc
wav\isolated_digits_ti_train_endpt\WOMAN\ES\OA_endpt.wav	mfctrain\10_112.mfc
wav\isolated_digits_ti_train_endpt\WOMAN\ES\OB_endpt.wav	mfctrain\10_113.mfc
wav\isolated_digits_ti_train_endpt\WOMAN\ES\ZA_endpt.wav	mfctrain\0_112.mfc
wav\isolated_digits_ti_train_endpt\WOMAN\ES\ZB_endpt.wav	mfctrain\0_113.mfc
wav\isolated_digits_ti_train_endpt\WOMAN\HG\1A_endpt.wav	mfctrain\1_116.mfc
wav\isolated_digits_ti_train_endpt\WOMAN\HG\1B_endpt.wav	mfctrain\1_117.mfc
wav\isolated_digits_ti_train_endpt\WOMAN\HG\2A_endpt.wav	mfctrain\2_116.mfc
wav\isolated_digits_ti_train_endpt\WOMAN\HG\2B_endpt.wav	mfctrain\2_117.mfc
wav\isolated_digits_ti_train_endpt\WOMAN\HG\3A_endpt.wav	mfctrain\3_114.mfc
wav\isolated_digits_ti_train_endpt\WOMAN\HG\3B_endpt.wav	mfctrain\3_115.mfc
wav\isolated_digits_ti_train_endpt\WOMAN\HG\4A_endpt.wav	mfctrain\4_114.mfc
wav\isolated_digits_ti_train_endpt\WOMAN\HG\4B_endpt.wav	mfctrain\4_115.mfc
wav\isolated_digits_ti_train_endpt\WOMAN\HG\5A_endpt.wav	mfctrain\5_114.mfc
wav\isolated_digits_ti_train_endpt\WOMAN\HG\5B_endpt.wav	mfctrain\5_115.mfc
wav\isolated_digits_ti_train_endpt\WOMAN\HG\6A_endpt.wav	mfctrain\6_114.mfc
wav\isolated_digits_ti_train_endpt\WOMAN\HG\6B_endpt.wav	mfctrain\6_115.mfc
wav\isolated_digits_ti_train_endpt\WOMAN\HG\7A_endpt.wav	mfctrain\7_114.mfc
wav\isolated_digits_ti_train_endpt\WOMAN\HG\7B_endpt.wav	mfctrain\7_115.mfc
wav\isolated_digits_ti_train_endpt\WOMAN\HG\8A_endpt.wav	mfctrain\8_114.mfc
wav\isolated_digits_ti_train_endpt\WOMAN\HG\8B_endpt.wav	mfctrain\8_115.mfc
wav\isolated_digits_ti_train_endpt\WOMAN\HG\9A_endpt.wav	mfctrain\9_114.mfc
wav\isolated_digits_ti_train_endpt\WOMAN\HG\9B_endpt.wav	mfctrain\9_115.mfc
wav\isolated_digits_ti_train_endpt\WOMAN\HG\OA_endpt.wav	mfctrain\10_114.mfc
wav\isolated_digits_ti_train_endpt\WOMAN\HG\OB_endpt.wav	mfctrain\10_115.mfc
wav\isolated_digits_ti_train_endpt\WOMAN\HG\ZA_endpt.wav	mfctrain\0_114.mfc
wav\isolated_digits_ti_train_endpt\WOMAN\HG\ZB_endpt.wav	mfctrain\0_115.mfc
wav\isolated_digits_ti_train_endpt\WOMAN\HP\1A_endpt.wav	mfctrain\1_118.mfc
wav\isolated_digits_ti_train_endpt\WOMAN\HP\1B_endpt.wav	mfctrain\1_119.mfc
wav\isolated_digits_ti_train_endpt\WOMAN\HP\2A_endpt.wav	mfctrain\2_118.mfc
wav\isolated_digits_ti_train_endpt\WOMAN\HP\2B_endpt.wav	mfctrain\2_119.mfc
wav\isolated_digits_ti_train_endpt\WOMAN\HP\3A_endpt.wav	mfctrain\3_116.mfc
wav\isolated_digits_ti_train_endpt\WOMAN\HP\3B_endpt.wav	mfctrain\3_117.mfc
wav\isolated_digits_ti_train_endpt\WOMAN\HP\4A_endpt.wav	mfctrain\4_116.mfc
wav\isolated_digits_ti_train_endpt\WOMAN\HP\4B_endpt.wav	mfctrain\4_117.mfc
wav\isolated_digits_ti_train_endpt\WOMAN\HP\5A_endpt.wav	mfctrain\5_116.mfc
wav\isolated_digits_ti_train_endpt\WOMAN\HP\5B_endpt.wav	mfctrain\5_117.mfc
wav\isolated_digits_ti_train_endpt\WOMAN\HP\6A_endpt.wav	mfctrain\6_116.mfc
wav\isolated_digits_ti_train_endpt\WOMAN\HP\6B_endpt.wav	mfctrain\6_117.mfc
wav\isolated_digits_ti_train_endpt\WOMAN\HP\7A_endpt.wav	mfctrain\7_116.mfc
wav\isolated_digits_ti_train_endpt\WOMAN\HP\7B_endpt.wav	mfctrain\7_117.mfc
wav\isolated_digits_ti_train_endpt\WOMAN\HP\8A_endpt.wav	mfctrain\8_116.mfc
wav\isolated_digits_ti_train_endpt\WOMAN\HP\8B_endpt.wav	mfctrain\8_117.mfc
wav\isolated_digits_ti_train_endpt\WOMAN\HP\9A_endpt.wav	mfctrain\9_116.mfc
wav\isolated_digits_ti_train_endpt\WOMAN\HP\9B_endpt.wav	mfctrain\9_117.mfc
wav\isolated_digits_ti_train_endpt\WOMAN\HP\OA_endpt.wav	mfctrain\10_116.mfc
wav\isolated_digits_ti_train_endpt\WOMAN\HP\OB_endpt.wav	mfctrain\10_117.mfc
wav\isolated_digits_ti_train_endpt\WOMAN\HP\ZA_endpt.wav	mfctrain\0_116.mfc
wav\isolated_digits_ti_train_endpt\WOMAN\HP\ZB_endpt.wav	mfctrain\0_117.mfc
wav\isolated_digits_ti_train_endpt\WOMAN\IG\1A_endpt.wav	mfctrain\1_120.mfc
wav\isolated_digits_ti_train_endpt\WOMAN\IG\1B_endpt.wav	mfctrain\1_121.mfc
wav\isolated_digits_ti_train_endpt\WOMAN\IG\2A_endpt.wav	mfctrain\2_120.mfc
wav\isolated_digits_ti_train_endpt\WOMAN\IG\2B_endpt.wav	mfctrain\2_121.mfc
wav\isolated_digits_ti_train_endpt\WOMAN\IG\3A_endpt.wav	mfctrain\3_118.mfc
wav\isolated_digits_ti_train_endpt\WOMAN\IG\3B_endpt.wav	mfctrain\3_119.mfc
wav\isolated_digits_ti_train_endpt\WOMAN\IG\4A_endpt.wav	mfctrain\4_118.mfc
wav\isolated_digits_ti_train_endpt\WOMAN\IG\4B_endpt.wav	mfctrain\4_119.mfc
wav\isolated_digits_ti_train_endpt\WOMAN\IG\5A_endpt.wav	mfctrain\5_118.mfc
wav\isolated_digits_ti_train_endpt\WOMAN\IG\5B_endpt.wav	mfctrain\5_119.mfc
wav\isolated_digits_ti_train_endpt\WOMAN\IG\6A_endpt.wav	mfctrain\6_118.mfc
wav\isolated_digits_ti_train_endpt\WOMAN\IG\6B_endpt.wav	mfctrain\6_119.mfc
wav\isolated_digits_ti_train_endpt\WOMAN\IG\7A_endpt.wav	mfctrain\7_118.mfc
wav\isolated_digits_ti_train_endpt\WOMAN\IG\7B_endpt.wav	mfctrain\7_119.mfc
wav\isolated_digits_ti_train_endpt\WOMAN\IG\8A_endpt.wav	mfctrain\8_118.mfc
wav\isolated_digits_ti_train_endpt\WOMAN\IG\8B_endpt.wav	mfctrain\8_119.mfc
wav\isolated_digits_ti_train_endpt\WOMAN\IG\9A_endpt.wav	mfctrain\9_118.mfc
wav\isolated_digits_ti_train_endpt\WOMAN\IG\9B_endpt.wav	mfctrain\9_119.mfc
wav\isolated_digits_ti_train_endpt\WOMAN\IG\OA_endpt.wav	mfctrain\10_118.mfc
wav\isolated_digits_ti_train_endpt\WOMAN\IG\OB_endpt.wav	mfctrain\10_119.mfc
wav\isolated_digits_ti_train_endpt\WOMAN\IG\ZA_endpt.wav	mfctrain\0_118.mfc
wav\isolated_digits_ti_train_endpt\WOMAN\IG\ZB_endpt.wav	mfctrain\0_119.mfc
wav\isolated_digits_ti_train_endpt\WOMAN\IH\1A_endpt.wav	mfctrain\1_122.mfc
wav\isolated_digits_ti_train_endpt\WOMAN\IH\1B_endpt.wav	mfctrain\1_123.mfc
wav\isolated_digits_ti_train_endpt\WOMAN\IH\2A_endpt.wav	mfctrain\2_122.mfc
wav\isolated_digits_ti_train_endpt\WOMAN\IH\2B_endpt.wav	mfctrain\2_123.mfc
wav\isolated_digits_ti_train_endpt\WOMAN\IH\3A_endpt.wav	mfctrain\3_120.mfc
wav\isolated_digits_ti_train_endpt\WOMAN\IH\3B_endpt.wav	mfctrain\3_121.mfc
wav\isolated_digits_ti_train_endpt\WOMAN\IH\4A_endpt.wav	mfctrain\4_120.mfc
wav\isolated_digits_ti_train_endpt\WOMAN\IH\4B_endpt.wav	mfctrain\4_121.mfc
wav\isolated_digits_ti_train_endpt\WOMAN\IH\5A_endpt.wav	mfctrain\5_120.mfc
wav\isolated_digits_ti_train_endpt\WOMAN\IH\5B_endpt.wav	mfctrain\5_121.mfc
wav\isolated_digits_ti_train_endpt\WOMAN\IH\6A_endpt.wav	mfctrain\6_120.mfc
wav\isolated_digits_ti_train_endpt\WOMAN\IH\6B_endpt.wav	mfctrain\6_121.mfc
wav\isolated_digits_ti_train_endpt\WOMAN\IH\7A_endpt.wav	mfctrain\7_120.mfc
wav\isolated_digits_ti_train_endpt\WOMAN\IH\7B_endpt.wav	mfctrain\7_121.mfc
wav\isolated_digits_ti_train_endpt\WOMAN\IH\8A_endpt.wav	mfctrain\8_120.mfc
wav\isolated_digits_ti_train_endpt\WOMAN\IH\8B_endpt.wav	mfctrain\8_121.mfc
wav\isolated_digits_ti_train_endpt\WOMAN\IH\9A_endpt.wav	mfctrain\9_120.mfc
wav\isolated_digits_ti_train_endpt\WOMAN\IH\9B_endpt.wav	mfctrain\9_121.mfc
wav\isolated_digits_ti_train_endpt\WOMAN\IH\OA_endpt.wav	mfctrain\10_120.mfc
wav\isolated_digits_ti_train_endpt\WOMAN\IH\OB_endpt.wav	mfctrain\10_121.mfc
wav\isolated_digits_ti_train_endpt\WOMAN\IH\ZA_endpt.wav	mfctrain\0_120.mfc
wav\isolated_digits_ti_train_endpt\WOMAN\IH\ZB_endpt.wav	mfctrain\0_121.mfc
wav\isolated_digits_ti_train_endpt\WOMAN\IL\1A_endpt.wav	mfctrain\1_124.mfc
wav\isolated_digits_ti_train_endpt\WOMAN\IL\1B_endpt.wav	mfctrain\1_125.mfc
wav\isolated_digits_ti_train_endpt\WOMAN\IL\2A_endpt.wav	mfctrain\2_124.mfc
wav\isolated_digits_ti_train_endpt\WOMAN\IL\2B_endpt.wav	mfctrain\2_125.mfc
wav\isolated_digits_ti_train_endpt\WOMAN\IL\3A_endpt.wav	mfctrain\3_122.mfc
wav\isolated_digits_ti_train_endpt\WOMAN\IL\3B_endpt.wav	mfctrain\3_123.mfc
wav\isolated_digits_ti_train_endpt\WOMAN\IL\4A_endpt.wav	mfctrain\4_122.mfc
wav\isolated_digits_ti_train_endpt\WOMAN\IL\4B_endpt.wav	mfctrain\4_123.mfc
wav\isolated_digits_ti_train_endpt\WOMAN\IL\5A_endpt.wav	mfctrain\5_122.mfc
wav\isolated_digits_ti_train_endpt\WOMAN\IL\5B_endpt.wav	mfctrain\5_123.mfc
wav\isolated_digits_ti_train_endpt\WOMAN\IL\6A_endpt.wav	mfctrain\6_122.mfc
wav\isolated_digits_ti_train_endpt\WOMAN\IL\6B_endpt.wav	mfctrain\6_123.mfc
wav\isolated_digits_ti_train_endpt\WOMAN\IL\7A_endpt.wav	mfctrain\7_122.mfc
wav\isolated_digits_ti_train_endpt\WOMAN\IL\7B_endpt.wav	mfctrain\7_123.mfc
wav\isolated_digits_ti_train_endpt\WOMAN\IL\8A_endpt.wav	mfctrain\8_122.mfc
wav\isolated_digits_ti_train_endpt\WOMAN\IL\8B_endpt.wav	mfctrain\8_123.mfc
wav\isolated_digits_ti_train_endpt\WOMAN\IL\9A_endpt.wav	mfctrain\9_122.mfc
wav\isolated_digits_ti_train_endpt\WOMAN\IL\9B_endpt.wav	mfctrain\9_123.mfc
wav\isolated_digits_ti_train_endpt\WOMAN\IL\OA_endpt.wav	mfctrain\10_122.mfc
wav\isolated_digits_ti_train_endpt\WOMAN\IL\OB_endpt.wav	mfctrain\10_123.mfc
wav\isolated_digits_ti_train_endpt\WOMAN\IL\ZA_endpt.wav	mfctrain\0_122.mfc
wav\isolated_digits_ti_train_endpt\WOMAN\IL\ZB_endpt.wav	mfctrain\0_123.mfc
wav\isolated_digits_ti_train_endpt\WOMAN\JC\1A_endpt.wav	mfctrain\1_126.mfc
wav\isolated_digits_ti_train_endpt\WOMAN\JC\1B_endpt.wav	mfctrain\1_127.mfc
wav\isolated_digits_ti_train_endpt\WOMAN\JC\2A_endpt.wav	mfctrain\2_126.mfc
wav\isolated_digits_ti_train_endpt\WOMAN\JC\2B_endpt.wav	mfctrain\2_127.mfc
wav\isolated_digits_ti_train_endpt\WOMAN\JC\3A_endpt.wav	mfctrain\3_124.mfc
wav\isolated_digits_ti_train_endpt\WOMAN\JC\3B_endpt.wav	mfctrain\3_125.mfc
wav\isolated_digits_ti_train_endpt\WOMAN\JC\4A_endpt.wav	mfctrain\4_124.mfc
wav\isolated_digits_ti_train_endpt\WOMAN\JC\4B_endpt.wav	mfctrain\4_125.mfc
wav\isolated_digits_ti_train_endpt\WOMAN\JC\5A_endpt.wav	mfctrain\5_124.mfc
wav\isolated_digits_ti_train_endpt\WOMAN\JC\5B_endpt.wav	mfctrain\5_125.mfc
wav\isolated_digits_ti_train_endpt\WOMAN\JC\6A_endpt.wav	mfctrain\6_124.mfc
wav\isolated_digits_ti_train_endpt\WOMAN\JC\6B_endpt.wav	mfctrain\6_125.mfc
wav\isolated_digits_ti_train_endpt\WOMAN\JC\7A_endpt.wav	mfctrain\7_124.mfc
wav\isolated_digits_ti_train_endpt\WOMAN\JC\7B_endpt.wav	mfctrain\7_125.mfc
wav\isolated_digits_ti_train_endpt\WOMAN\JC\8A_endpt.wav	mfctrain\8_124.mfc
wav\isolated_digits_ti_train_endpt\WOMAN\JC\8B_endpt.wav	mfctrain\8_125.mfc
wav\isolated_digits_ti_train_endpt\WOMAN\JC\9A_endpt.wav	mfctrain\9_124.mfc
wav\isolated_digits_ti_train_endpt\WOMAN\JC\9B_endpt.wav	mfctrain\9_125.mfc
wav\isolated_digits_ti_train_endpt\WOMAN\JC\OA_endpt.wav	mfctrain\10_124.mfc
wav\isolated_digits_ti_train_endpt\WOMAN\JC\OB_endpt.wav	mfctrain\10_125.mfc
wav\isolated_digits_ti_train_endpt\WOMAN\JC\ZA_endpt.wav	mfctrain\0_124.mfc
wav\isolated_digits_ti_train_endpt\WOMAN\JC\ZB_endpt.wav	mfctrain\0_125.mfc
wav\isolated_digits_ti_train_endpt\WOMAN\JI\1A_endpt.wav	mfctrain\1_128.mfc
wav\isolated_digits_ti_train_endpt\WOMAN\JI\1B_endpt.wav	mfctrain\1_129.mfc
wav\isolated_digits_ti_train_endpt\WOMAN\JI\2A_endpt.wav	mfctrain\2_128.mfc
wav\isolated_digits_ti_train_endpt\WOMAN\JI\2B_endpt.wav	mfctrain\2_129.mfc
wav\isolated_digits_ti_train_endpt\WOMAN\JI\3A_endpt.wav	mfctrain\3_126.mfc
wav\isolated_digits_ti_train_endpt\WOMAN\JI\3B_endpt.wav	mfctrain\3_127.mfc
wav\isolated_digits_ti_train_endpt\WOMAN\JI\4A_endpt.wav	mfctrain\4_126.mfc
wav\isolated_digits_ti_train_endpt\WOMAN\JI\4B_endpt.wav	mfctrain\4_127.mfc
wav\isolated_digits_ti_train_endpt\WOMAN\JI\5A_endpt.wav	mfctrain\5_126.mfc
wav\isolated_digits_ti_train_endpt\WOMAN\JI\5B_endpt.wav	mfctrain\5_127.mfc
wav\isolated_digits_ti_train_endpt\WOMAN\JI\6A_endpt.wav	mfctrain\6_126.mfc
wav\isolated_digits_ti_train_endpt\WOMAN\JI\6B_endpt.wav	mfctrain\6_127.mfc
wav\isolated_digits_ti_train_endpt\WOMAN\JI\7A_endpt.wav	mfctrain\7_126.mfc
wav\isolated_digits_ti_train_endpt\WOMAN\JI\7B_endpt.wav	mfctrain\7_127.mfc
wav\isolated_digits_ti_train_endpt\WOMAN\JI\8A_endpt.wav	mfctrain\8_126.mfc
wav\isolated_digits_ti_train_endpt\WOMAN\JI\8B_endpt.wav	mfctrain\8_127.mfc
wav\isolated_digits_ti_train_endpt\WOMAN\JI\9A_endpt.wav	mfctrain\9_126.mfc
wav\isolated_digits_ti_train_endpt\WOMAN\JI\9B_endpt.wav	mfctrain\9_127.mfc
wav\isolated_digits_ti_train_endpt\WOMAN\JI\OA_endpt.wav	mfctrain\10_126.mfc
wav\isolated_digits_ti_train_endpt\WOMAN\JI\OB_endpt.wav	mfctrain\10_127.mfc
wav\isolated_digits_ti_train_endpt\WOMAN\JI\ZA_endpt.wav	mfctrain\0_126.mfc
wav\isolated_digits_ti_train_endpt\WOMAN\JI\ZB_endpt.wav	mfctrain\0_127.mfc
wav\isolated_digits_ti_train_endpt\WOMAN\JJ\1A_endpt.wav	mfctrain\1_130.mfc
wav\isolated_digits_ti_train_endpt\WOMAN\JJ\1B_endpt.wav	mfctrain\1_131.mfc
wav\isolated_digits_ti_train_endpt\WOMAN\JJ\2A_endpt.wav	mfctrain\2_130.mfc
wav\isolated_digits_ti_train_endpt\WOMAN\JJ\2B_endpt.wav	mfctrain\2_131.mfc
wav\isolated_digits_ti_train_endpt\WOMAN\JJ\3A_endpt.wav	mfctrain\3_128.mfc
wav\isolated_digits_ti_train_endpt\WOMAN\JJ\3B_endpt.wav	mfctrain\3_129.mfc
wav\isolated_digits_ti_train_endpt\WOMAN\JJ\4A_endpt.wav	mfctrain\4_128.mfc
wav\isolated_digits_ti_train_endpt\WOMAN\JJ\4B_endpt.wav	mfctrain\4_129.mfc
wav\isolated_digits_ti_train_endpt\WOMAN\JJ\5A_endpt.wav	mfctrain\5_128.mfc
wav\isolated_digits_ti_train_endpt\WOMAN\JJ\5B_endpt.wav	mfctrain\5_129.mfc
wav\isolated_digits_ti_train_endpt\WOMAN\JJ\6A_endpt.wav	mfctrain\6_128.mfc
wav\isolated_digits_ti_train_endpt\WOMAN\JJ\6B_endpt.wav	mfctrain\6_129.mfc
wav\isolated_digits_ti_train_endpt\WOMAN\JJ\7A_endpt.wav	mfctrain\7_128.mfc
wav\isolated_digits_ti_train_endpt\WOMAN\JJ\7B_endpt.wav	mfctrain\7_129.mfc
wav\isolated_digits_ti_train_endpt\WOMAN\JJ\8A_endpt.wav	mfctrain\8_128.mfc
wav\isolated_digits_ti_train_endpt\WOMAN\JJ\8B_endpt.wav	mfctrain\8_129.mfc
wav\isolated_digits_ti_train_endpt\WOMAN\JJ\9A_endpt.wav	mfctrain\9_128.mfc
wav\isolated_digits_ti_train_endpt\WOMAN\JJ\9B_endpt.wav	mfctrain\9_129.mfc
wav\isolated_digits_ti_train_endpt\WOMAN\JJ\OA_endpt.wav	mfctrain\10_128.mfc
wav\isolated_digits_ti_train_endpt\WOMAN\JJ\OB_endpt.wav	mfctrain\10_129.mfc
wav\isolated_digits_ti_train_endpt\WOMAN\JJ\ZA_endpt.wav	mfctrain\0_128.mfc
wav\isolated_digits_ti_train_endpt\WOMAN\JJ\ZB_endpt.wav	mfctrain\0_129.mfc
wav\isolated_digits_ti_train_endpt\WOMAN\JN\1A_endpt.wav	mfctrain\1_132.mfc
wav\isolated_digits_ti_train_endpt\WOMAN\JN\1B_endpt.wav	mfctrain\1_133.mfc
wav\isolated_digits_ti_train_endpt\WOMAN\JN\2A_endpt.wav	mfctrain\2_132.mfc
wav\isolated_digits_ti_train_endpt\WOMAN\JN\2B_endpt.wav	mfctrain\2_133.mfc
wav\isolated_digits_ti_train_endpt\WOMAN\JN\3A_endpt.wav	mfctrain\3_130.mfc
wav\isolated_digits_ti_train_endpt\WOMAN\JN\3B_endpt.wav	mfctrain\3_131.mfc
wav\isolated_digits_ti_train_endpt\WOMAN\JN\4A_endpt.wav	mfctrain\4_130.mfc
wav\isolated_digits_ti_train_endpt\WOMAN\JN\4B_endpt.wav	mfctrain\4_131.mfc
wav\isolated_digits_ti_train_endpt\WOMAN\JN\5A_endpt.wav	mfctrain\5_130.mfc
wav\isolated_digits_ti_train_endpt\WOMAN\JN\5B_endpt.wav	mfctrain\5_131.mfc
wav\isolated_digits_ti_train_endpt\WOMAN\JN\6A_endpt.wav	mfctrain\6_130.mfc
wav\isolated_digits_ti_train_endpt\WOMAN\JN\6B_endpt.wav	mfctrain\6_131.mfc
wav\isolated_digits_ti_train_endpt\WOMAN\JN\7A_endpt.wav	mfctrain\7_130.mfc
wav\isolated_digits_ti_train_endpt\WOMAN\JN\7B_endpt.wav	mfctrain\7_131.mfc
wav\isolated_digits_ti_train_endpt\WOMAN\JN\8A_endpt.wav	mfctrain\8_130.mfc
wav\isolated_digits_ti_train_endpt\WOMAN\JN\8B_endpt.wav	mfctrain\8_131.mfc
wav\isolated_digits_ti_train_endpt\WOMAN\JN\9A_endpt.wav	mfctrain\9_130.mfc
wav\isolated_digits_ti_train_endpt\WOMAN\JN\9B_endpt.wav	mfctrain\9_131.mfc
wav\isolated_digits_ti_train_endpt\WOMAN\JN\OA_endpt.wav	mfctrain\10_130.mfc
wav\isolated_digits_ti_train_endpt\WOMAN\JN\OB_endpt.wav	mfctrain\10_131.mfc
wav\isolated_digits_ti_train_endpt\WOMAN\JN\ZA_endpt.wav	mfctrain\0_130.mfc
wav\isolated_digits_ti_train_endpt\WOMAN\JN\ZB_endpt.wav	mfctrain\0_131.mfc
wav\isolated_digits_ti_train_endpt\WOMAN\JP\1A_endpt.wav	mfctrain\1_134.mfc
wav\isolated_digits_ti_train_endpt\WOMAN\JP\1B_endpt.wav	mfctrain\1_135.mfc
wav\isolated_digits_ti_train_endpt\WOMAN\JP\2A_endpt.wav	mfctrain\2_134.mfc
wav\isolated_digits_ti_train_endpt\WOMAN\JP\2B_endpt.wav	mfctrain\2_135.mfc
wav\isolated_digits_ti_train_endpt\WOMAN\JP\3A_endpt.wav	mfctrain\3_132.mfc
wav\isolated_digits_ti_train_endpt\WOMAN\JP\3B_endpt.wav	mfctrain\3_133.mfc
wav\isolated_digits_ti_train_endpt\WOMAN\JP\4A_endpt.wav	mfctrain\4_132.mfc
wav\isolated_digits_ti_train_endpt\WOMAN\JP\4B_endpt.wav	mfctrain\4_133.mfc
wav\isolated_digits_ti_train_endpt\WOMAN\JP\5A_endpt.wav	mfctrain\5_132.mfc
wav\isolated_digits_ti_train_endpt\WOMAN\JP\5B_endpt.wav	mfctrain\5_133.mfc
wav\isolated_digits_ti_train_endpt\WOMAN\JP\6A_endpt.wav	mfctrain\6_132.mfc
wav\isolated_digits_ti_train_endpt\WOMAN\JP\6B_endpt.wav	mfctrain\6_133.mfc
wav\isolated_digits_ti_train_endpt\WOMAN\JP\7A_endpt.wav	mfctrain\7_132.mfc
wav\isolated_digits_ti_train_endpt\WOMAN\JP\7B_endpt.wav	mfctrain\7_133.mfc
wav\isolated_digits_ti_train_endpt\WOMAN\JP\8A_endpt.wav	mfctrain\8_132.mfc
wav\isolated_digits_ti_train_endpt\WOMAN\JP\8B_endpt.wav	mfctrain\8_133.mfc
wav\isolated_digits_ti_train_endpt\WOMAN\JP\9A_endpt.wav	mfctrain\9_132.mfc
wav\isolated_digits_ti_train_endpt\WOMAN\JP\9B_endpt.wav	mfctrain\9_133.mfc
wav\isolated_digits_ti_train_endpt\WOMAN\JP\OA_endpt.wav	mfctrain\10_132.mfc
wav\isolated_digits_ti_train_endpt\WOMAN\JP\OB_endpt.wav	mfctrain\10_133.mfc
wav\isolated_digits_ti_train_endpt\WOMAN\JP\ZA_endpt.wav	mfctrain\0_132.mfc
wav\isolated_digits_ti_train_endpt\WOMAN\JP\ZB_endpt.wav	mfctrain\0_133.mfc
wav\isolated_digits_ti_train_endpt\WOMAN\KC\1A_endpt.wav	mfctrain\1_136.mfc
wav\isolated_digits_ti_train_endpt\WOMAN\KC\1B_endpt.wav	mfctrain\1_137.mfc
wav\isolated_digits_ti_train_endpt\WOMAN\KC\2A_endpt.wav	mfctrain\2_136.mfc
wav\isolated_digits_ti_train_endpt\WOMAN\KC\2B_endpt.wav	mfctrain\2_137.mfc
wav\isolated_digits_ti_train_endpt\WOMAN\KC\3A_endpt.wav	mfctrain\3_134.mfc
wav\isolated_digits_ti_train_endpt\WOMAN\KC\3B_endpt.wav	mfctrain\3_135.mfc
wav\isolated_digits_ti_train_endpt\WOMAN\KC\4A_endpt.wav	mfctrain\4_134.mfc
wav\isolated_digits_ti_train_endpt\WOMAN\KC\4B_endpt.wav	mfctrain\4_135.mfc
wav\isolated_digits_ti_train_endpt\WOMAN\KC\5A_endpt.wav	mfctrain\5_134.mfc
wav\isolated_digits_ti_train_endpt\WOMAN\KC\5B_endpt.wav	mfctrain\5_135.mfc
wav\isolated_digits_ti_train_endpt\WOMAN\KC\6A_endpt.wav	mfctrain\6_134.mfc
wav\isolated_digits_ti_train_endpt\WOMAN\KC\6B_endpt.wav	mfctrain\6_135.mfc
wav\isolated_digits_ti_train_endpt\WOMAN\KC\7A_endpt.wav	mfctrain\7_134.mfc
wav\isolated_digits_ti_train_endpt\WOMAN\KC\7B_endpt.wav	mfctrain\7_135.mfc
wav\isolated_digits_ti_train_endpt\WOMAN\KC\8A_endpt.wav	mfctrain\8_134.mfc
wav\isolated_digits_ti_train_endpt\WOMAN\KC\8B_endpt.wav	mfctrain\8_135.mfc
wav\isolated_digits_ti_train_endpt\WOMAN\KC\9A_endpt.wav	mfctrain\9_134.mfc
wav\isolated_digits_ti_train_endpt\WOMAN\KC\9B_endpt.wav	mfctrain\9_135.mfc
wav\isolated_digits_ti_train_endpt\WOMAN\KC\OA_endpt.wav	mfctrain\10_134.mfc
wav\isolated_digits_ti_train_endpt\WOMAN\KC\OB_endpt.wav	mfctrain\10_135.mfc
wav\isolated_digits_ti_train_endpt\WOMAN\KC\ZA_endpt.wav	mfctrain\0_134.mfc
wav\isolated_digits_ti_train_endpt\WOMAN\KC\ZB_endpt.wav	mfctrain\0_135.mfc
wav\isolated_digits_ti_train_endpt\WOMAN\KF\1A_endpt.wav	mfctrain\1_138.mfc
wav\isolated_digits_ti_train_endpt\WOMAN\KF\1B_endpt.wav	mfctrain\1_139.mfc
wav\isolated_digits_ti_train_endpt\WOMAN\KF\2A_endpt.wav	mfctrain\2_138.mfc
wav\isolated_digits_ti_train_endpt\WOMAN\KF\2B_endpt.wav	mfctrain\2_139.mfc
wav\isolated_digits_ti_train_endpt\WOMAN\KF\3A_endpt.wav	mfctrain\3_136.mfc
wav\isolated_digits_ti_train_endpt\WOMAN\KF\3B_endpt.wav	mfctrain\3_137.mfc
wav\isolated_digits_ti_train_endpt\WOMAN\KF\4A_endpt.wav	mfctrain\4_136.mfc
wav\isolated_digits_ti_train_endpt\WOMAN\KF\4B_endpt.wav	mfctrain\4_137.mfc
wav\isolated_digits_ti_train_endpt\WOMAN\KF\5A_endpt.wav	mfctrain\5_136.mfc
wav\isolated_digits_ti_train_endpt\WOMAN\KF\5B_endpt.wav	mfctrain\5_137.mfc
wav\isolated_digits_ti_train_endpt\WOMAN\KF\6A_endpt.wav	mfctrain\6_136.mfc
wav\isolated_digits_ti_train_endpt\WOMAN\KF\6B_endpt.wav	mfctrain\6_137.mfc
wav\isolated_digits_ti_train_endpt\WOMAN\KF\7A_endpt.wav	mfctrain\7_136.mfc
wav\isolated_digits_ti_train_endpt\WOMAN\KF\7B_endpt.wav	mfctrain\7_137.mfc
wav\isolated_digits_ti_train_endpt\WOMAN\KF\8A_endpt.wav	mfctrain\8_136.mfc
wav\isolated_digits_ti_train_endpt\WOMAN\KF\8B_endpt.wav	mfctrain\8_137.mfc
wav\isolated_digits_ti_train_endpt\WOMAN\KF\9A_endpt.wav	mfctrain\9_136.mfc
wav\isolated_digits_ti_train_endpt\WOMAN\KF\9B_endpt.wav	mfctrain\9_137.mfc
wav\isolated_digits_ti_train_endpt\WOMAN\KF\OA_endpt.wav	mfctrain\10_136.mfc
wav\isolated_digits_ti_train_endpt\WOMAN\KF\OB_endpt.wav	mfctrain\10_137.mfc
wav\isolated_digits_ti_train_endpt\WOMAN\KF\ZA_endpt.wav	mfctrain\0_136.mfc
wav\isolated_digits_ti_train_endpt\WOMAN\KF\ZB_endpt.wav	mfctrain\0_137.mfc
wav\isolated_digits_ti_train_endpt\WOMAN\KH\1A_endpt.wav	mfctrain\1_140.mfc
wav\isolated_digits_ti_train_endpt\WOMAN\KH\1B_endpt.wav	mfctrain\1_141.mfc
wav\isolated_digits_ti_train_endpt\WOMAN\KH\2A_endpt.wav	mfctrain\2_140.mfc
wav\isolated_digits_ti_train_endpt\WOMAN\KH\2B_endpt.wav	mfctrain\2_141.mfc
wav\isolated_digits_ti_train_endpt\WOMAN\KH\3A_endpt.wav	mfctrain\3_138.mfc
wav\isolated_digits_ti_train_endpt\WOMAN\KH\3B_endpt.wav	mfctrain\3_139.mfc
wav\isolated_digits_ti_train_endpt\WOMAN\KH\4A_endpt.wav	mfctrain\4_138.mfc
wav\isolated_digits_ti_train_endpt\WOMAN\KH\4B_endpt.wav	mfctrain\4_139.mfc
wav\isolated_digits_ti_train_endpt\WOMAN\KH\5A_endpt.wav	mfctrain\5_138.mfc
wav\isolated_digits_ti_train_endpt\WOMAN\KH\5B_endpt.wav	mfctrain\5_139.mfc
wav\isolated_digits_ti_train_endpt\WOMAN\KH\6A_endpt.wav	mfctrain\6_138.mfc
wav\isolated_digits_ti_train_endpt\WOMAN\KH\6B_endpt.wav	mfctrain\6_139.mfc
wav\isolated_digits_ti_train_endpt\WOMAN\KH\7A_endpt.wav	mfctrain\7_138.mfc
wav\isolated_digits_ti_train_endpt\WOMAN\KH\7B_endpt.wav	mfctrain\7_139.mfc
wav\isolated_digits_ti_train_endpt\WOMAN\KH\8A_endpt.wav	mfctrain\8_138.mfc
wav\isolated_digits_ti_train_endpt\WOMAN\KH\8B_endpt.wav	mfctrain\8_139.mfc
wav\isolated_digits_ti_train_endpt\WOMAN\KH\9A_endpt.wav	mfctrain\9_138.mfc
wav\isolated_digits_ti_train_endpt\WOMAN\KH\9B_endpt.wav	mfctrain\9_139.mfc
wav\isolated_digits_ti_train_endpt\WOMAN\KH\OA_endpt.wav	mfctrain\10_138.mfc
wav\isolated_digits_ti_train_endpt\WOMAN\KH\OB_endpt.wav	mfctrain\10_139.mfc
wav\isolated_digits_ti_train_endpt\WOMAN\KH\ZA_endpt.wav	mfctrain\0_138.mfc
wav\isolated_digits_ti_train_endpt\WOMAN\KH\ZB_endpt.wav	mfctrain\0_139.mfc
wav\isolated_digits_ti_train_endpt\WOMAN\KK\1A_endpt.wav	mfctrain\1_142.mfc
wav\isolated_digits_ti_train_endpt\WOMAN\KK\1B_endpt.wav	mfctrain\1_143.mfc
wav\isolated_digits_ti_train_endpt\WOMAN\KK\2A_endpt.wav	mfctrain\2_142.mfc
wav\isolated_digits_ti_train_endpt\WOMAN\KK\2B_endpt.wav	mfctrain\2_143.mfc
wav\isolated_digits_ti_train_endpt\WOMAN\KK\3A_endpt.wav	mfctrain\3_140.mfc
wav\isolated_digits_ti_train_endpt\WOMAN\KK\3B_endpt.wav	mfctrain\3_141.mfc
wav\isolated_digits_ti_train_endpt\WOMAN\KK\4A_endpt.wav	mfctrain\4_140.mfc
wav\isolated_digits_ti_train_endpt\WOMAN\KK\4B_endpt.wav	mfctrain\4_141.mfc
wav\isolated_digits_ti_train_endpt\WOMAN\KK\5A_endpt.wav	mfctrain\5_140.mfc
wav\isolated_digits_ti_train_endpt\WOMAN\KK\5B_endpt.wav	mfctrain\5_141.mfc
wav\isolated_digits_ti_train_endpt\WOMAN\KK\6A_endpt.wav	mfctrain\6_140.mfc
wav\isolated_digits_ti_train_endpt\WOMAN\KK\6B_endpt.wav	mfctrain\6_141.mfc
wav\isolated_digits_ti_train_endpt\WOMAN\KK\7A_endpt.wav	mfctrain\7_140.mfc
wav\isolated_digits_ti_train_endpt\WOMAN\KK\7B_endpt.wav	mfctrain\7_141.mfc
wav\isolated_digits_ti_train_endpt\WOMAN\KK\8A_endpt.wav	mfctrain\8_140.mfc
wav\isolated_digits_ti_train_endpt\WOMAN\KK\8B_endpt.wav	mfctrain\8_141.mfc
wav\isolated_digits_ti_train_endpt\WOMAN\KK\9A_endpt.wav	mfctrain\9_140.mfc
wav\isolated_digits_ti_train_endpt\WOMAN\KK\9B_endpt.wav	mfctrain\9_141.mfc
wav\isolated_digits_ti_train_endpt\WOMAN\KK\OA_endpt.wav	mfctrain\10_140.mfc
wav\isolated_digits_ti_train_endpt\WOMAN\KK\OB_endpt.wav	mfctrain\10_141.mfc
wav\isolated_digits_ti_train_endpt\WOMAN\KK\ZA_endpt.wav	mfctrain\0_140.mfc
wav\isolated_digits_ti_train_endpt\WOMAN\KK\ZB_endpt.wav	mfctrain\0_141.mfc
wav\isolated_digits_ti_train_endpt\WOMAN\KN\1A_endpt.wav	mfctrain\1_144.mfc
wav\isolated_digits_ti_train_endpt\WOMAN\KN\1B_endpt.wav	mfctrain\1_145.mfc
wav\isolated_digits_ti_train_endpt\WOMAN\KN\2A_endpt.wav	mfctrain\2_144.mfc
wav\isolated_digits_ti_train_endpt\WOMAN\KN\2B_endpt.wav	mfctrain\2_145.mfc
wav\isolated_digits_ti_train_endpt\WOMAN\KN\3A_endpt.wav	mfctrain\3_142.mfc
wav\isolated_digits_ti_train_endpt\WOMAN\KN\3B_endpt.wav	mfctrain\3_143.mfc
wav\isolated_digits_ti_train_endpt\WOMAN\KN\4A_endpt.wav	mfctrain\4_142.mfc
wav\isolated_digits_ti_train_endpt\WOMAN\KN\4B_endpt.wav	mfctrain\4_143.mfc
wav\isolated_digits_ti_train_endpt\WOMAN\KN\5A_endpt.wav	mfctrain\5_142.mfc
wav\isolated_digits_ti_train_endpt\WOMAN\KN\5B_endpt.wav	mfctrain\5_143.mfc
wav\isolated_digits_ti_train_endpt\WOMAN\KN\6A_endpt.wav	mfctrain\6_142.mfc
wav\isolated_digits_ti_train_endpt\WOMAN\KN\6B_endpt.wav	mfctrain\6_143.mfc
wav\isolated_digits_ti_train_endpt\WOMAN\KN\7A_endpt.wav	mfctrain\7_142.mfc
wav\isolated_digits_ti_train_endpt\WOMAN\KN\7B_endpt.wav	mfctrain\7_143.mfc
wav\isolated_digits_ti_train_endpt\WOMAN\KN\8A_endpt.wav	mfctrain\8_142.mfc
wav\isolated_digits_ti_train_endpt\WOMAN\KN\8B_endpt.wav	mfctrain\8_143.mfc
wav\isolated_digits_ti_train_endpt\WOMAN\KN\9A_endpt.wav	mfctrain\9_142.mfc
wav\isolated_digits_ti_train_endpt\WOMAN\KN\9B_endpt.wav	mfctrain\9_143.mfc
wav\isolated_digits_ti_train_endpt\WOMAN\KN\OA_endpt.wav	mfctrain\10_142.mfc
wav\isolated_digits_ti_train_endpt\WOMAN\KN\OB_endpt.wav	mfctrain\10_143.mfc
wav\isolated_digits_ti_train_endpt\WOMAN\KN\ZA_endpt.wav	mfctrain\0_142.mfc
wav\isolated_digits_ti_train_endpt\WOMAN\KN\ZB_endpt.wav	mfctrain\0_143.mfc
wav\isolated_digits_ti_train_endpt\WOMAN\KT\1A_endpt.wav	mfctrain\1_146.mfc
wav\isolated_digits_ti_train_endpt\WOMAN\KT\1B_endpt.wav	mfctrain\1_147.mfc
wav\isolated_digits_ti_train_endpt\WOMAN\KT\2A_endpt.wav	mfctrain\2_146.mfc
wav\isolated_digits_ti_train_endpt\WOMAN\KT\2B_endpt.wav	mfctrain\2_147.mfc
wav\isolated_digits_ti_train_endpt\WOMAN\KT\3A_endpt.wav	mfctrain\3_144.mfc
wav\isolated_digits_ti_train_endpt\WOMAN\KT\3B_endpt.wav	mfctrain\3_145.mfc
wav\isolated_digits_ti_train_endpt\WOMAN\KT\4A_endpt.wav	mfctrain\4_144.mfc
wav\isolated_digits_ti_train_endpt\WOMAN\KT\4B_endpt.wav	mfctrain\4_145.mfc
wav\isolated_digits_ti_train_endpt\WOMAN\KT\5A_endpt.wav	mfctrain\5_144.mfc
wav\isolated_digits_ti_train_endpt\WOMAN\KT\5B_endpt.wav	mfctrain\5_145.mfc
wav\isolated_digits_ti_train_endpt\WOMAN\KT\6A_endpt.wav	mfctrain\6_144.mfc
wav\isolated_digits_ti_train_endpt\WOMAN\KT\6B_endpt.wav	mfctrain\6_145.mfc
wav\isolated_digits_ti_train_endpt\WOMAN\KT\7A_endpt.wav	mfctrain\7_144.mfc
wav\isolated_digits_ti_train_endpt\WOMAN\KT\7B_endpt.wav	mfctrain\7_145.mfc
wav\isolated_digits_ti_train_endpt\WOMAN\KT\8A_endpt.wav	mfctrain\8_144.mfc
wav\isolated_digits_ti_train_endpt\WOMAN\KT\8B_endpt.wav	mfctrain\8_145.mfc
wav\isolated_digits_ti_train_endpt\WOMAN\KT\9A_endpt.wav	mfctrain\9_144.mfc
wav\isolated_digits_ti_train_endpt\WOMAN\KT\9B_endpt.wav	mfctrain\9_145.mfc
wav\isolated_digits_ti_train_endpt\WOMAN\KT\OA_endpt.wav	mfctrain\10_144.mfc
wav\isolated_digits_ti_train_endpt\WOMAN\KT\OB_endpt.wav	mfctrain\10_145.mfc
wav\isolated_digits_ti_train_endpt\WOMAN\KT\ZA_endpt.wav	mfctrain\0_144.mfc
wav\isolated_digits_ti_train_endpt\WOMAN\KT\ZB_endpt.wav	mfctrain\0_145.mfc
wav\isolated_digits_ti_train_endpt\WOMAN\LA\1A_endpt.wav	mfctrain\1_148.mfc
wav\isolated_digits_ti_train_endpt\WOMAN\LA\1B_endpt.wav	mfctrain\1_149.mfc
wav\isolated_digits_ti_train_endpt\WOMAN\LA\2A_endpt.wav	mfctrain\2_148.mfc
wav\isolated_digits_ti_train_endpt\WOMAN\LA\2B_endpt.wav	mfctrain\2_149.mfc
wav\isolated_digits_ti_train_endpt\WOMAN\LA\3A_endpt.wav	mfctrain\3_146.mfc
wav\isolated_digits_ti_train_endpt\WOMAN\LA\3B_endpt.wav	mfctrain\3_147.mfc
wav\isolated_digits_ti_train_endpt\WOMAN\LA\4A_endpt.wav	mfctrain\4_146.mfc
wav\isolated_digits_ti_train_endpt\WOMAN\LA\4B_endpt.wav	mfctrain\4_147.mfc
wav\isolated_digits_ti_train_endpt\WOMAN\LA\5A_endpt.wav	mfctrain\5_146.mfc
wav\isolated_digits_ti_train_endpt\WOMAN\LA\5B_endpt.wav	mfctrain\5_147.mfc
wav\isolated_digits_ti_train_endpt\WOMAN\LA\6A_endpt.wav	mfctrain\6_146.mfc
wav\isolated_digits_ti_train_endpt\WOMAN\LA\6B_endpt.wav	mfctrain\6_147.mfc
wav\isolated_digits_ti_train_endpt\WOMAN\LA\7A_endpt.wav	mfctrain\7_146.mfc
wav\isolated_digits_ti_train_endpt\WOMAN\LA\7B_endpt.wav	mfctrain\7_147.mfc
wav\isolated_digits_ti_train_endpt\WOMAN\LA\8A_endpt.wav	mfctrain\8_146.mfc
wav\isolated_digits_ti_train_endpt\WOMAN\LA\8B_endpt.wav	mfctrain\8_147.mfc
wav\isolated_digits_ti_train_endpt\WOMAN\LA\9A_endpt.wav	mfctrain\9_146.mfc
wav\isolated_digits_ti_train_endpt\WOMAN\LA\9B_endpt.wav	mfctrain\9_147.mfc
wav\isolated_digits_ti_train_endpt\WOMAN\LA\OA_endpt.wav	mfctrain\10_146.mfc
wav\isolated_digits_ti_train_endpt\WOMAN\LA\OB_endpt.wav	mfctrain\10_147.mfc
wav\isolated_digits_ti_train_endpt\WOMAN\LA\ZA_endpt.wav	mfctrain\0_146.mfc
wav\isolated_digits_ti_train_endpt\WOMAN\LA\ZB_endpt.wav	mfctrain\0_147.mfc
wav\isolated_digits_ti_train_endpt\WOMAN\LD\1A_endpt.wav	mfctrain\1_150.mfc
wav\isolated_digits_ti_train_endpt\WOMAN\LD\1B_endpt.wav	mfctrain\1_151.mfc
wav\isolated_digits_ti_train_endpt\WOMAN\LD\2A_endpt.wav	mfctrain\2_150.mfc
wav\isolated_digits_ti_train_endpt\WOMAN\LD\2B_endpt.wav	mfctrain\2_151.mfc
wav\isolated_digits_ti_train_endpt\WOMAN\LD\3A_endpt.wav	mfctrain\3_148.mfc
wav\isolated_digits_ti_train_endpt\WOMAN\LD\3B_endpt.wav	mfctrain\3_149.mfc
wav\isolated_digits_ti_train_endpt\WOMAN\LD\4A_endpt.wav	mfctrain\4_148.mfc
wav\isolated_digits_ti_train_endpt\WOMAN\LD\4B_endpt.wav	mfctrain\4_149.mfc
wav\isolated_digits_ti_train_endpt\WOMAN\LD\5A_endpt.wav	mfctrain\5_148.mfc
wav\isolated_digits_ti_train_endpt\WOMAN\LD\5B_endpt.wav	mfctrain\5_149.mfc
wav\isolated_digits_ti_train_endpt\WOMAN\LD\6A_endpt.wav	mfctrain\6_148.mfc
wav\isolated_digits_ti_train_endpt\WOMAN\LD\6B_endpt.wav	mfctrain\6_149.mfc
wav\isolated_digits_ti_train_endpt\WOMAN\LD\7A_endpt.wav	mfctrain\7_148.mfc
wav\isolated_digits_ti_train_endpt\WOMAN\LD\7B_endpt.wav	mfctrain\7_149.mfc
wav\isolated_digits_ti_train_endpt\WOMAN\LD\8A_endpt.wav	mfctrain\8_148.mfc
wav\isolated_digits_ti_train_endpt\WOMAN\LD\8B_endpt.wav	mfctrain\8_149.mfc
wav\isolated_digits_ti_train_endpt\WOMAN\LD\9A_endpt.wav	mfctrain\9_148.mfc
wav\isolated_digits_ti_train_endpt\WOMAN\LD\9B_endpt.wav	mfctrain\9_149.mfc
wav\isolated_digits_ti_train_endpt\WOMAN\LD\OA_endpt.wav	mfctrain\10_148.mfc
wav\isolated_digits_ti_train_endpt\WOMAN\LD\OB_endpt.wav	mfctrain\10_149.mfc
wav\isolated_digits_ti_train_endpt\WOMAN\LD\ZA_endpt.wav	mfctrain\0_148.mfc
wav\isolated_digits_ti_train_endpt\WOMAN\LD\ZB_endpt.wav	mfctrain\0_149.mfc
wav\isolated_digits_ti_train_endpt\WOMAN\LS\1A_endpt.wav	mfctrain\1_152.mfc
wav\isolated_digits_ti_train_endpt\WOMAN\LS\1B_endpt.wav	mfctrain\1_153.mfc
wav\isolated_digits_ti_train_endpt\WOMAN\LS\2A_endpt.wav	mfctrain\2_152.mfc
wav\isolated_digits_ti_train_endpt\WOMAN\LS\2B_endpt.wav	mfctrain\2_153.mfc
wav\isolated_digits_ti_train_endpt\WOMAN\LS\3A_endpt.wav	mfctrain\3_150.mfc
wav\isolated_digits_ti_train_endpt\WOMAN\LS\3B_endpt.wav	mfctrain\3_151.mfc
wav\isolated_digits_ti_train_endpt\WOMAN\LS\4A_endpt.wav	mfctrain\4_150.mfc
wav\isolated_digits_ti_train_endpt\WOMAN\LS\4B_endpt.wav	mfctrain\4_151.mfc
wav\isolated_digits_ti_train_endpt\WOMAN\LS\5A_endpt.wav	mfctrain\5_150.mfc
wav\isolated_digits_ti_train_endpt\WOMAN\LS\5B_endpt.wav	mfctrain\5_151.mfc
wav\isolated_digits_ti_train_endpt\WOMAN\LS\6A_endpt.wav	mfctrain\6_150.mfc
wav\isolated_digits_ti_train_endpt\WOMAN\LS\6B_endpt.wav	mfctrain\6_151.mfc
wav\isolated_digits_ti_train_endpt\WOMAN\LS\7A_endpt.wav	mfctrain\7_150.mfc
wav\isolated_digits_ti_train_endpt\WOMAN\LS\7B_endpt.wav	mfctrain\7_151.mfc
wav\isolated_digits_ti_train_endpt\WOMAN\LS\8A_endpt.wav	mfctrain\8_150.mfc
wav\isolated_digits_ti_train_endpt\WOMAN\LS\8B_endpt.wav	mfctrain\8_151.mfc
wav\isolated_digits_ti_train_endpt\WOMAN\LS\9A_endpt.wav	mfctrain\9_150.mfc
wav\isolated_digits_ti_train_endpt\WOMAN\LS\9B_endpt.wav	mfctrain\9_151.mfc
wav\isolated_digits_ti_train_endpt\WOMAN\LS\OA_endpt.wav	mfctrain\10_150.mfc
wav\isolated_digits_ti_train_endpt\WOMAN\LS\OB_endpt.wav	mfctrain\10_151.mfc
wav\isolated_digits_ti_train_endpt\WOMAN\LS\ZA_endpt.wav	mfctrain\0_150.mfc
wav\isolated_digits_ti_train_endpt\WOMAN\LS\ZB_endpt.wav	mfctrain\0_151.mfc
wav\isolated_digits_ti_train_endpt\WOMAN\MK\1A_endpt.wav	mfctrain\1_154.mfc
wav\isolated_digits_ti_train_endpt\WOMAN\MK\1B_endpt.wav	mfctrain\1_155.mfc
wav\isolated_digits_ti_train_endpt\WOMAN\MK\2A_endpt.wav	mfctrain\2_154.mfc
wav\isolated_digits_ti_train_endpt\WOMAN\MK\2B_endpt.wav	mfctrain\2_155.mfc
wav\isolated_digits_ti_train_endpt\WOMAN\MK\3A_endpt.wav	mfctrain\3_152.mfc
wav\isolated_digits_ti_train_endpt\WOMAN\MK\3B_endpt.wav	mfctrain\3_153.mfc
wav\isolated_digits_ti_train_endpt\WOMAN\MK\4A_endpt.wav	mfctrain\4_152.mfc
wav\isolated_digits_ti_train_endpt\WOMAN\MK\4B_endpt.wav	mfctrain\4_153.mfc
wav\isolated_digits_ti_train_endpt\WOMAN\MK\5A_endpt.wav	mfctrain\5_152.mfc
wav\isolated_digits_ti_train_endpt\WOMAN\MK\5B_endpt.wav	mfctrain\5_153.mfc
wav\isolated_digits_ti_train_endpt\WOMAN\MK\6A_endpt.wav	mfctrain\6_152.mfc
wav\isolated_digits_ti_train_endpt\WOMAN\MK\6B_endpt.wav	mfctrain\6_153.mfc
wav\isolated_digits_ti_train_endpt\WOMAN\MK\7A_endpt.wav	mfctrain\7_152.mfc
wav\isolated_digits_ti_train_endpt\WOMAN\MK\7B_endpt.wav	mfctrain\7_153.mfc
wav\isolated_digits_ti_train_endpt\WOMAN\MK\8A_endpt.wav	mfctrain\8_152.mfc
wav\isolated_digits_ti_train_endpt\WOMAN\MK\8B_endpt.wav	mfctrain\8_153.mfc
wav\isolated_digits_ti_train_endpt\WOMAN\MK\9A_endpt.wav	mfctrain\9_152.mfc
wav\isolated_digits_ti_train_endpt\WOMAN\MK\9B_endpt.wav	mfctrain\9_153.mfc
wav\isolated_digits_ti_train_endpt\WOMAN\MK\OA_endpt.wav	mfctrain\10_152.mfc
wav\isolated_digits_ti_train_endpt\WOMAN\MK\OB_endpt.wav	mfctrain\10_153.mfc
wav\isolated_digits_ti_train_endpt\WOMAN\MK\ZA_endpt.wav	mfctrain\0_152.mfc
wav\isolated_digits_ti_train_endpt\WOMAN\MK\ZB_endpt.wav	mfctrain\0_153.mfc
wav\isolated_digits_ti_train_endpt\WOMAN\MM\1A_endpt.wav	mfctrain\1_156.mfc
wav\isolated_digits_ti_train_endpt\WOMAN\MM\1B_endpt.wav	mfctrain\1_157.mfc
wav\isolated_digits_ti_train_endpt\WOMAN\MM\2A_endpt.wav	mfctrain\2_156.mfc
wav\isolated_digits_ti_train_endpt\WOMAN\MM\2B_endpt.wav	mfctrain\2_157.mfc
wav\isolated_digits_ti_train_endpt\WOMAN\MM\3A_endpt.wav	mfctrain\3_154.mfc
wav\isolated_digits_ti_train_endpt\WOMAN\MM\3B_endpt.wav	mfctrain\3_155.mfc
wav\isolated_digits_ti_train_endpt\WOMAN\MM\4A_endpt.wav	mfctrain\4_154.mfc
wav\isolated_digits_ti_train_endpt\WOMAN\MM\4B_endpt.wav	mfctrain\4_155.mfc
wav\isolated_digits_ti_train_endpt\WOMAN\MM\5A_endpt.wav	mfctrain\5_154.mfc
wav\isolated_digits_ti_train_endpt\WOMAN\MM\5B_endpt.wav	mfctrain\5_155.mfc
wav\isolated_digits_ti_train_endpt\WOMAN\MM\6A_endpt.wav	mfctrain\6_154.mfc
wav\isolated_digits_ti_train_endpt\WOMAN\MM\6B_endpt.wav	mfctrain\6_155.mfc
wav\isolated_digits_ti_train_endpt\WOMAN\MM\7A_endpt.wav	mfctrain\7_154.mfc
wav\isolated_digits_ti_train_endpt\WOMAN\MM\7B_endpt.wav	mfctrain\7_155.mfc
wav\isolated_digits_ti_train_endpt\WOMAN\MM\8A_endpt.wav	mfctrain\8_154.mfc
wav\isolated_digits_ti_train_endpt\WOMAN\MM\8B_endpt.wav	mfctrain\8_155.mfc
wav\isolated_digits_ti_train_endpt\WOMAN\MM\9A_endpt.wav	mfctrain\9_154.mfc
wav\isolated_digits_ti_train_endpt\WOMAN\MM\9B_endpt.wav	mfctrain\9_155.mfc
wav\isolated_digits_ti_train_endpt\WOMAN\MM\OA_endpt.wav	mfctrain\10_154.mfc
wav\isolated_digits_ti_train_endpt\WOMAN\MM\OB_endpt.wav	mfctrain\10_155.mfc
wav\isolated_digits_ti_train_endpt\WOMAN\MM\ZA_endpt.wav	mfctrain\0_154.mfc
wav\isolated_digits_ti_train_endpt\WOMAN\MM\ZB_endpt.wav	mfctrain\0_155.mfc
wav\isolated_digits_ti_train_endpt\WOMAN\MS\1A_endpt.wav	mfctrain\1_158.mfc
wav\isolated_digits_ti_train_endpt\WOMAN\MS\1B_endpt.wav	mfctrain\1_159.mfc
wav\isolated_digits_ti_train_endpt\WOMAN\MS\2A_endpt.wav	mfctrain\2_158.mfc
wav\isolated_digits_ti_train_endpt\WOMAN\MS\2B_endpt.wav	mfctrain\2_159.mfc
wav\isolated_digits_ti_train_endpt\WOMAN\MS\3A_endpt.wav	mfctrain\3_156.mfc
wav\isolated_digits_ti_train_endpt\WOMAN\MS\3B_endpt.wav	mfctrain\3_157.mfc
wav\isolated_digits_ti_train_endpt\WOMAN\MS\4A_endpt.wav	mfctrain\4_156.mfc
wav\isolated_digits_ti_train_endpt\WOMAN\MS\4B_endpt.wav	mfctrain\4_157.mfc
wav\isolated_digits_ti_train_endpt\WOMAN\MS\5A_endpt.wav	mfctrain\5_156.mfc
wav\isolated_digits_ti_train_endpt\WOMAN\MS\5B_endpt.wav	mfctrain\5_157.mfc
wav\isolated_digits_ti_train_endpt\WOMAN\MS\6A_endpt.wav	mfctrain\6_156.mfc
wav\isolated_digits_ti_train_endpt\WOMAN\MS\6B_endpt.wav	mfctrain\6_157.mfc
wav\isolated_digits_ti_train_endpt\WOMAN\MS\7A_endpt.wav	mfctrain\7_156.mfc
wav\isolated_digits_ti_train_endpt\WOMAN\MS\7B_endpt.wav	mfctrain\7_157.mfc
wav\isolated_digits_ti_train_endpt\WOMAN\MS\8A_endpt.wav	mfctrain\8_156.mfc
wav\isolated_digits_ti_train_endpt\WOMAN\MS\8B_endpt.wav	mfctrain\8_157.mfc
wav\isolated_digits_ti_train_endpt\WOMAN\MS\9A_endpt.wav	mfctrain\9_156.mfc
wav\isolated_digits_ti_train_endpt\WOMAN\MS\9B_endpt.wav	mfctrain\9_157.mfc
wav\isolated_digits_ti_train_endpt\WOMAN\MS\OA_endpt.wav	mfctrain\10_156.mfc
wav\isolated_digits_ti_train_endpt\WOMAN\MS\OB_endpt.wav	mfctrain\10_157.mfc
wav\isolated_digits_ti_train_endpt\WOMAN\MS\ZA_endpt.wav	mfctrain\0_156.mfc
wav\isolated_digits_ti_train_endpt\WOMAN\MS\ZB_endpt.wav	mfctrain\0_157.mfc
wav\isolated_digits_ti_train_endpt\WOMAN\MW\1A_endpt.wav	mfctrain\1_160.mfc
wav\isolated_digits_ti_train_endpt\WOMAN\MW\1B_endpt.wav	mfctrain\1_161.mfc
wav\isolated_digits_ti_train_endpt\WOMAN\MW\2A_endpt.wav	mfctrain\2_160.mfc
wav\isolated_digits_ti_train_endpt\WOMAN\MW\2B_endpt.wav	mfctrain\2_161.mfc
wav\isolated_digits_ti_train_endpt\WOMAN\MW\3A_endpt.wav	mfctrain\3_158.mfc
wav\isolated_digits_ti_train_endpt\WOMAN\MW\3B_endpt.wav	mfctrain\3_159.mfc
wav\isolated_digits_ti_train_endpt\WOMAN\MW\4A_endpt.wav	mfctrain\4_158.mfc
wav\isolated_digits_ti_train_endpt\WOMAN\MW\4B_endpt.wav	mfctrain\4_159.mfc
wav\isolated_digits_ti_train_endpt\WOMAN\MW\5A_endpt.wav	mfctrain\5_158.mfc
wav\isolated_digits_ti_train_endpt\WOMAN\MW\5B_endpt.wav	mfctrain\5_159.mfc
wav\isolated_digits_ti_train_endpt\WOMAN\MW\6A_endpt.wav	mfctrain\6_158.mfc
wav\isolated_digits_ti_train_endpt\WOMAN\MW\6B_endpt.wav	mfctrain\6_159.mfc
wav\isolated_digits_ti_train_endpt\WOMAN\MW\7A_endpt.wav	mfctrain\7_158.mfc
wav\isolated_digits_ti_train_endpt\WOMAN\MW\7B_endpt.wav	mfctrain\7_159.mfc
wav\isolated_digits_ti_train_endpt\WOMAN\MW\8A_endpt.wav	mfctrain\8_158.mfc
wav\isolated_digits_ti_train_endpt\WOMAN\MW\8B_endpt.wav	mfctrain\8_159.mfc
wav\isolated_digits_ti_train_endpt\WOMAN\MW\9A_endpt.wav	mfctrain\9_158.mfc
wav\isolated_digits_ti_train_endpt\WOMAN\MW\9B_endpt.wav	mfctrain\9_159.mfc
wav\isolated_digits_ti_train_endpt\WOMAN\MW\OA_endpt.wav	mfctrain\10_158.mfc
wav\isolated_digits_ti_train_endpt\WOMAN\MW\OB_endpt.wav	mfctrain\10_159.mfc
wav\isolated_digits_ti_train_endpt\WOMAN\MW\ZA_endpt.wav	mfctrain\0_158.mfc
wav\isolated_digits_ti_train_endpt\WOMAN\MW\ZB_endpt.wav	mfctrain\0_159.mfc
wav\isolated_digits_ti_train_endpt\WOMAN\NC\1A_endpt.wav	mfctrain\1_162.mfc
wav\isolated_digits_ti_train_endpt\WOMAN\NC\1B_endpt.wav	mfctrain\1_163.mfc
wav\isolated_digits_ti_train_endpt\WOMAN\NC\2A_endpt.wav	mfctrain\2_162.mfc
wav\isolated_digits_ti_train_endpt\WOMAN\NC\2B_endpt.wav	mfctrain\2_163.mfc
wav\isolated_digits_ti_train_endpt\WOMAN\NC\3A_endpt.wav	mfctrain\3_160.mfc
wav\isolated_digits_ti_train_endpt\WOMAN\NC\3B_endpt.wav	mfctrain\3_161.mfc
wav\isolated_digits_ti_train_endpt\WOMAN\NC\4A_endpt.wav	mfctrain\4_160.mfc
wav\isolated_digits_ti_train_endpt\WOMAN\NC\4B_endpt.wav	mfctrain\4_161.mfc
wav\isolated_digits_ti_train_endpt\WOMAN\NC\5A_endpt.wav	mfctrain\5_160.mfc
wav\isolated_digits_ti_train_endpt\WOMAN\NC\5B_endpt.wav	mfctrain\5_161.mfc
wav\isolated_digits_ti_train_endpt\WOMAN\NC\6A_endpt.wav	mfctrain\6_160.mfc
wav\isolated_digits_ti_train_endpt\WOMAN\NC\6B_endpt.wav	mfctrain\6_161.mfc
wav\isolated_digits_ti_train_endpt\WOMAN\NC\7A_endpt.wav	mfctrain\7_160.mfc
wav\isolated_digits_ti_train_endpt\WOMAN\NC\7B_endpt.wav	mfctrain\7_161.mfc
wav\isolated_digits_ti_train_endpt\WOMAN\NC\8A_endpt.wav	mfctrain\8_160.mfc
wav\isolated_digits_ti_train_endpt\WOMAN\NC\8B_endpt.wav	mfctrain\8_161.mfc
wav\isolated_digits_ti_train_endpt\WOMAN\NC\9A_endpt.wav	mfctrain\9_160.mfc
wav\isolated_digits_ti_train_endpt\WOMAN\NC\9B_endpt.wav	mfctrain\9_161.mfc
wav\isolated_digits_ti_train_endpt\WOMAN\NC\OA_endpt.wav	mfctrain\10_160.mfc
wav\isolated_digits_ti_train_endpt\WOMAN\NC\OB_endpt.wav	mfctrain\10_161.mfc
wav\isolated_digits_ti_train_endpt\WOMAN\NC\ZA_endpt.wav	mfctrain\0_160.mfc
wav\isolated_digits_ti_train_endpt\WOMAN\NC\ZB_endpt.wav	mfctrain\0_161.mfc
wav\isolated_digits_ti_train_endpt\WOMAN\NG\1A_endpt.wav	mfctrain\1_164.mfc
wav\isolated_digits_ti_train_endpt\WOMAN\NG\1B_endpt.wav	mfctrain\1_165.mfc
wav\isolated_digits_ti_train_endpt\WOMAN\NG\2A_endpt.wav	mfctrain\2_164.mfc
wav\isolated_digits_ti_train_endpt\WOMAN\NG\2B_endpt.wav	mfctrain\2_165.mfc
wav\isolated_digits_ti_train_endpt\WOMAN\NG\3A_endpt.wav	mfctrain\3_162.mfc
wav\isolated_digits_ti_train_endpt\WOMAN\NG\3B_endpt.wav	mfctrain\3_163.mfc
wav\isolated_digits_ti_train_endpt\WOMAN\NG\4A_endpt.wav	mfctrain\4_162.mfc
wav\isolated_digits_ti_train_endpt\WOMAN\NG\4B_endpt.wav	mfctrain\4_163.mfc
wav\isolated_digits_ti_train_endpt\WOMAN\NG\5A_endpt.wav	mfctrain\5_162.mfc
wav\isolated_digits_ti_train_endpt\WOMAN\NG\5B_endpt.wav	mfctrain\5_163.mfc
wav\isolated_digits_ti_train_endpt\WOMAN\NG\6A_endpt.wav	mfctrain\6_162.mfc
wav\isolated_digits_ti_train_endpt\WOMAN\NG\6B_endpt.wav	mfctrain\6_163.mfc
wav\isolated_digits_ti_train_endpt\WOMAN\NG\7A_endpt.wav	mfctrain\7_162.mfc
wav\isolated_digits_ti_train_endpt\WOMAN\NG\7B_endpt.wav	mfctrain\7_163.mfc
wav\isolated_digits_ti_train_endpt\WOMAN\NG\8A_endpt.wav	mfctrain\8_162.mfc
wav\isolated_digits_ti_train_endpt\WOMAN\NG\8B_endpt.wav	mfctrain\8_163.mfc
wav\isolated_digits_ti_train_endpt\WOMAN\NG\9A_endpt.wav	mfctrain\9_162.mfc
wav\isolated_digits_ti_train_endpt\WOMAN\NG\9B_endpt.wav	mfctrain\9_163.mfc
wav\isolated_digits_ti_train_endpt\WOMAN\NG\OA_endpt.wav	mfctrain\10_162.mfc
wav\isolated_digits_ti_train_endpt\WOMAN\NG\OB_endpt.wav	mfctrain\10_163.mfc
wav\isolated_digits_ti_train_endpt\WOMAN\NG\ZA_endpt.wav	mfctrain\0_162.mfc
wav\isolated_digits_ti_train_endpt\WOMAN\NG\ZB_endpt.wav	mfctrain\0_163.mfc
wav\isolated_digits_ti_train_endpt\WOMAN\NH\1A_endpt.wav	mfctrain\1_166.mfc
wav\isolated_digits_ti_train_endpt\WOMAN\NH\1B_endpt.wav	mfctrain\1_167.mfc
wav\isolated_digits_ti_train_endpt\WOMAN\NH\2A_endpt.wav	mfctrain\2_166.mfc
wav\isolated_digits_ti_train_endpt\WOMAN\NH\2B_endpt.wav	mfctrain\2_167.mfc
wav\isolated_digits_ti_train_endpt\WOMAN\NH\3A_endpt.wav	mfctrain\3_164.mfc
wav\isolated_digits_ti_train_endpt\WOMAN\NH\3B_endpt.wav	mfctrain\3_165.mfc
wav\isolated_digits_ti_train_endpt\WOMAN\NH\4A_endpt.wav	mfctrain\4_164.mfc
wav\isolated_digits_ti_train_endpt\WOMAN\NH\4B_endpt.wav	mfctrain\4_165.mfc
wav\isolated_digits_ti_train_endpt\WOMAN\NH\5A_endpt.wav	mfctrain\5_164.mfc
wav\isolated_digits_ti_train_endpt\WOMAN\NH\5B_endpt.wav	mfctrain\5_165.mfc
wav\isolated_digits_ti_train_endpt\WOMAN\NH\6A_endpt.wav	mfctrain\6_164.mfc
wav\isolated_digits_ti_train_endpt\WOMAN\NH\6B_endpt.wav	mfctrain\6_165.mfc
wav\isolated_digits_ti_train_endpt\WOMAN\NH\7A_endpt.wav	mfctrain\7_164.mfc
wav\isolated_digits_ti_train_endpt\WOMAN\NH\7B_endpt.wav	mfctrain\7_165.mfc
wav\isolated_digits_ti_train_endpt\WOMAN\NH\8A_endpt.wav	mfctrain\8_164.mfc
wav\isolated_digits_ti_train_endpt\WOMAN\NH\8B_endpt.wav	mfctrain\8_165.mfc
wav\isolated_digits_ti_train_endpt\WOMAN\NH\9A_endpt.wav	mfctrain\9_164.mfc
wav\isolated_digits_ti_train_endpt\WOMAN\NH\9B_endpt.wav	mfctrain\9_165.mfc
wav\isolated_digits_ti_train_endpt\WOMAN\NH\OA_endpt.wav	mfctrain\10_164.mfc
wav\isolated_digits_ti_train_endpt\WOMAN\NH\OB_endpt.wav	mfctrain\10_165.mfc
wav\isolated_digits_ti_train_endpt\WOMAN\NH\ZA_endpt.wav	mfctrain\0_164.mfc
wav\isolated_digits_ti_train_endpt\WOMAN\NH\ZB_endpt.wav	mfctrain\0_165.mfc
wav\isolated_digits_ti_train_endpt\WOMAN\PE\1A_endpt.wav	mfctrain\1_168.mfc
wav\isolated_digits_ti_train_endpt\WOMAN\PE\1B_endpt.wav	mfctrain\1_169.mfc
wav\isolated_digits_ti_train_endpt\WOMAN\PE\2A_endpt.wav	mfctrain\2_168.mfc
wav\isolated_digits_ti_train_endpt\WOMAN\PE\2B_endpt.wav	mfctrain\2_169.mfc
wav\isolated_digits_ti_train_endpt\WOMAN\PE\3A_endpt.wav	mfctrain\3_166.mfc
wav\isolated_digits_ti_train_endpt\WOMAN\PE\3B_endpt.wav	mfctrain\3_167.mfc
wav\isolated_digits_ti_train_endpt\WOMAN\PE\4A_endpt.wav	mfctrain\4_166.mfc
wav\isolated_digits_ti_train_endpt\WOMAN\PE\4B_endpt.wav	mfctrain\4_167.mfc
wav\isolated_digits_ti_train_endpt\WOMAN\PE\5A_endpt.wav	mfctrain\5_166.mfc
wav\isolated_digits_ti_train_endpt\WOMAN\PE\5B_endpt.wav	mfctrain\5_167.mfc
wav\isolated_digits_ti_train_endpt\WOMAN\PE\6A_endpt.wav	mfctrain\6_166.mfc
wav\isolated_digits_ti_train_endpt\WOMAN\PE\6B_endpt.wav	mfctrain\6_167.mfc
wav\isolated_digits_ti_train_endpt\WOMAN\PE\7A_endpt.wav	mfctrain\7_166.mfc
wav\isolated_digits_ti_train_endpt\WOMAN\PE\7B_endpt.wav	mfctrain\7_167.mfc
wav\isolated_digits_ti_train_endpt\WOMAN\PE\8A_endpt.wav	mfctrain\8_166.mfc
wav\isolated_digits_ti_train_endpt\WOMAN\PE\8B_endpt.wav	mfctrain\8_167.mfc
wav\isolated_digits_ti_train_endpt\WOMAN\PE\9A_endpt.wav	mfctrain\9_166.mfc
wav\isolated_digits_ti_train_endpt\WOMAN\PE\9B_endpt.wav	mfctrain\9_167.mfc
wav\isolated_digits_ti_train_endpt\WOMAN\PE\OA_endpt.wav	mfctrain\10_166.mfc
wav\isolated_digits_ti_train_endpt\WOMAN\PE\OB_endpt.wav	mfctrain\10_167.mfc
wav\isolated_digits_ti_train_endpt\WOMAN\PE\ZA_endpt.wav	mfctrain\0_166.mfc
wav\isolated_digits_ti_train_endpt\WOMAN\PE\ZB_endpt.wav	mfctrain\0_167.mfc
wav\isolated_digits_ti_train_endpt\WOMAN\PK\1A_endpt.wav	mfctrain\1_170.mfc
wav\isolated_digits_ti_train_endpt\WOMAN\PK\1B_endpt.wav	mfctrain\1_171.mfc
wav\isolated_digits_ti_train_endpt\WOMAN\PK\2A_endpt.wav	mfctrain\2_170.mfc
wav\isolated_digits_ti_train_endpt\WOMAN\PK\2B_endpt.wav	mfctrain\2_171.mfc
wav\isolated_digits_ti_train_endpt\WOMAN\PK\3A_endpt.wav	mfctrain\3_168.mfc
wav\isolated_digits_ti_train_endpt\WOMAN\PK\3B_endpt.wav	mfctrain\3_169.mfc
wav\isolated_digits_ti_train_endpt\WOMAN\PK\4A_endpt.wav	mfctrain\4_168.mfc
wav\isolated_digits_ti_train_endpt\WOMAN\PK\4B_endpt.wav	mfctrain\4_169.mfc
wav\isolated_digits_ti_train_endpt\WOMAN\PK\5A_endpt.wav	mfctrain\5_168.mfc
wav\isolated_digits_ti_train_endpt\WOMAN\PK\5B_endpt.wav	mfctrain\5_169.mfc
wav\isolated_digits_ti_train_endpt\WOMAN\PK\6A_endpt.wav	mfctrain\6_168.mfc
wav\isolated_digits_ti_train_endpt\WOMAN\PK\6B_endpt.wav	mfctrain\6_169.mfc
wav\isolated_digits_ti_train_endpt\WOMAN\PK\7A_endpt.wav	mfctrain\7_168.mfc
wav\isolated_digits_ti_train_endpt\WOMAN\PK\7B_endpt.wav	mfctrain\7_169.mfc
wav\isolated_digits_ti_train_endpt\WOMAN\PK\8A_endpt.wav	mfctrain\8_168.mfc
wav\isolated_digits_ti_train_endpt\WOMAN\PK\8B_endpt.wav	mfctrain\8_169.mfc
wav\isolated_digits_ti_train_endpt\WOMAN\PK\9A_endpt.wav	mfctrain\9_168.mfc
wav\isolated_digits_ti_train_endpt\WOMAN\PK\9B_endpt.wav	mfctrain\9_169.mfc
wav\isolated_digits_ti_train_endpt\WOMAN\PK\OA_endpt.wav	mfctrain\10_168.mfc
wav\isolated_digits_ti_train_endpt\WOMAN\PK\OB_endpt.wav	mfctrain\10_169.mfc
wav\isolated_digits_ti_train_endpt\WOMAN\PK\ZA_endpt.wav	mfctrain\0_168.mfc
wav\isolated_digits_ti_train_endpt\WOMAN\PK\ZB_endpt.wav	mfctrain\0_169.mfc
wav\isolated_digits_ti_train_endpt\WOMAN\PM\1A_endpt.wav	mfctrain\1_172.mfc
wav\isolated_digits_ti_train_endpt\WOMAN\PM\1B_endpt.wav	mfctrain\1_173.mfc
wav\isolated_digits_ti_train_endpt\WOMAN\PM\2A_endpt.wav	mfctrain\2_172.mfc
wav\isolated_digits_ti_train_endpt\WOMAN\PM\2B_endpt.wav	mfctrain\2_173.mfc
wav\isolated_digits_ti_train_endpt\WOMAN\PM\3A_endpt.wav	mfctrain\3_170.mfc
wav\isolated_digits_ti_train_endpt\WOMAN\PM\3B_endpt.wav	mfctrain\3_171.mfc
wav\isolated_digits_ti_train_endpt\WOMAN\PM\4A_endpt.wav	mfctrain\4_170.mfc
wav\isolated_digits_ti_train_endpt\WOMAN\PM\4B_endpt.wav	mfctrain\4_171.mfc
wav\isolated_digits_ti_train_endpt\WOMAN\PM\5A_endpt.wav	mfctrain\5_170.mfc
wav\isolated_digits_ti_train_endpt\WOMAN\PM\5B_endpt.wav	mfctrain\5_171.mfc
wav\isolated_digits_ti_train_endpt\WOMAN\PM\6A_endpt.wav	mfctrain\6_170.mfc
wav\isolated_digits_ti_train_endpt\WOMAN\PM\6B_endpt.wav	mfctrain\6_171.mfc
wav\isolated_digits_ti_train_endpt\WOMAN\PM\7A_endpt.wav	mfctrain\7_170.mfc
wav\isolated_digits_ti_train_endpt\WOMAN\PM\7B_endpt.wav	mfctrain\7_171.mfc
wav\isolated_digits_ti_train_endpt\WOMAN\PM\8A_endpt.wav	mfctrain\8_170.mfc
wav\isolated_digits_ti_train_endpt\WOMAN\PM\8B_endpt.wav	mfctrain\8_171.mfc
wav\isolated_digits_ti_train_endpt\WOMAN\PM\9A_endpt.wav	mfctrain\9_170.mfc
wav\isolated_digits_ti_train_endpt\WOMAN\PM\9B_endpt.wav	mfctrain\9_171.mfc
wav\isolated_digits_ti_train_endpt\WOMAN\PM\OA_endpt.wav	mfctrain\10_170.mfc
wav\isolated_digits_ti_train_endpt\WOMAN\PM\OB_endpt.wav	mfctrain\10_171.mfc
wav\isolated_digits_ti_train_endpt\WOMAN\PM\ZA_endpt.wav	mfctrain\0_170.mfc
wav\isolated_digits_ti_train_endpt\WOMAN\PM\ZB_endpt.wav	mfctrain\0_171.mfc
wav\isolated_digits_ti_train_endpt\WOMAN\PP\1A_endpt.wav	mfctrain\1_174.mfc
wav\isolated_digits_ti_train_endpt\WOMAN\PP\1B_endpt.wav	mfctrain\1_175.mfc
wav\isolated_digits_ti_train_endpt\WOMAN\PP\2A_endpt.wav	mfctrain\2_174.mfc
wav\isolated_digits_ti_train_endpt\WOMAN\PP\2B_endpt.wav	mfctrain\2_175.mfc
wav\isolated_digits_ti_train_endpt\WOMAN\PP\3A_endpt.wav	mfctrain\3_172.mfc
wav\isolated_digits_ti_train_endpt\WOMAN\PP\3B_endpt.wav	mfctrain\3_173.mfc
wav\isolated_digits_ti_train_endpt\WOMAN\PP\4A_endpt.wav	mfctrain\4_172.mfc
wav\isolated_digits_ti_train_endpt\WOMAN\PP\4B_endpt.wav	mfctrain\4_173.mfc
wav\isolated_digits_ti_train_endpt\WOMAN\PP\5A_endpt.wav	mfctrain\5_172.mfc
wav\isolated_digits_ti_train_endpt\WOMAN\PP\5B_endpt.wav	mfctrain\5_173.mfc
wav\isolated_digits_ti_train_endpt\WOMAN\PP\6A_endpt.wav	mfctrain\6_172.mfc
wav\isolated_digits_ti_train_endpt\WOMAN\PP\6B_endpt.wav	mfctrain\6_173.mfc
wav\isolated_digits_ti_train_endpt\WOMAN\PP\7A_endpt.wav	mfctrain\7_172.mfc
wav\isolated_digits_ti_train_endpt\WOMAN\PP\7B_endpt.wav	mfctrain\7_173.mfc
wav\isolated_digits_ti_train_endpt\WOMAN\PP\8A_endpt.wav	mfctrain\8_172.mfc
wav\isolated_digits_ti_train_endpt\WOMAN\PP\8B_endpt.wav	mfctrain\8_173.mfc
wav\isolated_digits_ti_train_endpt\WOMAN\PP\9A_endpt.wav	mfctrain\9_172.mfc
wav\isolated_digits_ti_train_endpt\WOMAN\PP\9B_endpt.wav	mfctrain\9_173.mfc
wav\isolated_digits_ti_train_endpt\WOMAN\PP\OA_endpt.wav	mfctrain\10_172.mfc
wav\isolated_digits_ti_train_endpt\WOMAN\PP\OB_endpt.wav	mfctrain\10_173.mfc
wav\isolated_digits_ti_train_endpt\WOMAN\PP\ZA_endpt.wav	mfctrain\0_172.mfc
wav\isolated_digits_ti_train_endpt\WOMAN\PP\ZB_endpt.wav	mfctrain\0_173.mfc
wav\isolated_digits_ti_train_endpt\WOMAN\RA\1A_endpt.wav	mfctrain\1_176.mfc
wav\isolated_digits_ti_train_endpt\WOMAN\RA\1B_endpt.wav	mfctrain\1_177.mfc
wav\isolated_digits_ti_train_endpt\WOMAN\RA\2A_endpt.wav	mfctrain\2_176.mfc
wav\isolated_digits_ti_train_endpt\WOMAN\RA\2B_endpt.wav	mfctrain\2_177.mfc
wav\isolated_digits_ti_train_endpt\WOMAN\RA\3A_endpt.wav	mfctrain\3_174.mfc
wav\isolated_digits_ti_train_endpt\WOMAN\RA\3B_endpt.wav	mfctrain\3_175.mfc
wav\isolated_digits_ti_train_endpt\WOMAN\RA\4A_endpt.wav	mfctrain\4_174.mfc
wav\isolated_digits_ti_train_endpt\WOMAN\RA\4B_endpt.wav	mfctrain\4_175.mfc
wav\isolated_digits_ti_train_endpt\WOMAN\RA\5A_endpt.wav	mfctrain\5_174.mfc
wav\isolated_digits_ti_train_endpt\WOMAN\RA\5B_endpt.wav	mfctrain\5_175.mfc
wav\isolated_digits_ti_train_endpt\WOMAN\RA\6A_endpt.wav	mfctrain\6_174.mfc
wav\isolated_digits_ti_train_endpt\WOMAN\RA\6B_endpt.wav	mfctrain\6_175.mfc
wav\isolated_digits_ti_train_endpt\WOMAN\RA\7A_endpt.wav	mfctrain\7_174.mfc
wav\isolated_digits_ti_train_endpt\WOMAN\RA\7B_endpt.wav	mfctrain\7_175.mfc
wav\isolated_digits_ti_train_endpt\WOMAN\RA\8A_endpt.wav	mfctrain\8_174.mfc
wav\isolated_digits_ti_train_endpt\WOMAN\RA\8B_endpt.wav	mfctrain\8_175.mfc
wav\isolated_digits_ti_train_endpt\WOMAN\RA\9A_endpt.wav	mfctrain\9_174.mfc
wav\isolated_digits_ti_train_endpt\WOMAN\RA\9B_endpt.wav	mfctrain\9_175.mfc
wav\isolated_digits_ti_train_endpt\WOMAN\RA\OA_endpt.wav	mfctrain\10_174.mfc
wav\isolated_digits_ti_train_endpt\WOMAN\RA\OB_endpt.wav	mfctrain\10_175.mfc
wav\isolated_digits_ti_train_endpt\WOMAN\RA\ZA_endpt.wav	mfctrain\0_174.mfc
wav\isolated_digits_ti_train_endpt\WOMAN\RA\ZB_endpt.wav	mfctrain\0_175.mfc
wav\isolated_digits_ti_train_endpt\WOMAN\RE\1A_endpt.wav	mfctrain\1_178.mfc
wav\isolated_digits_ti_train_endpt\WOMAN\RE\1B_endpt.wav	mfctrain\1_179.mfc
wav\isolated_digits_ti_train_endpt\WOMAN\RE\2A_endpt.wav	mfctrain\2_178.mfc
wav\isolated_digits_ti_train_endpt\WOMAN\RE\2B_endpt.wav	mfctrain\2_179.mfc
wav\isolated_digits_ti_train_endpt\WOMAN\RE\3A_endpt.wav	mfctrain\3_176.mfc
wav\isolated_digits_ti_train_endpt\WOMAN\RE\3B_endpt.wav	mfctrain\3_177.mfc
wav\isolated_digits_ti_train_endpt\WOMAN\RE\4A_endpt.wav	mfctrain\4_176.mfc
wav\isolated_digits_ti_train_endpt\WOMAN\RE\4B_endpt.wav	mfctrain\4_177.mfc
wav\isolated_digits_ti_train_endpt\WOMAN\RE\5A_endpt.wav	mfctrain\5_176.mfc
wav\isolated_digits_ti_train_endpt\WOMAN\RE\5B_endpt.wav	mfctrain\5_177.mfc
wav\isolated_digits_ti_train_endpt\WOMAN\RE\6A_endpt.wav	mfctrain\6_176.mfc
wav\isolated_digits_ti_train_endpt\WOMAN\RE\6B_endpt.wav	mfctrain\6_177.mfc
wav\isolated_digits_ti_train_endpt\WOMAN\RE\7A_endpt.wav	mfctrain\7_176.mfc
wav\isolated_digits_ti_train_endpt\WOMAN\RE\7B_endpt.wav	mfctrain\7_177.mfc
wav\isolated_digits_ti_train_endpt\WOMAN\RE\8A_endpt.wav	mfctrain\8_176.mfc
wav\isolated_digits_ti_train_endpt\WOMAN\RE\8B_endpt.wav	mfctrain\8_177.mfc
wav\isolated_digits_ti_train_endpt\WOMAN\RE\9A_endpt.wav	mfctrain\9_176.mfc
wav\isolated_digits_ti_train_endpt\WOMAN\RE\9B_endpt.wav	mfctrain\9_177.mfc
wav\isolated_digits_ti_train_endpt\WOMAN\RE\OA_endpt.wav	mfctrain\10_176.mfc
wav\isolated_digits_ti_train_endpt\WOMAN\RE\OB_endpt.wav	mfctrain\10_177.mfc
wav\isolated_digits_ti_train_endpt\WOMAN\RE\ZA_endpt.wav	mfctrain\0_176.mfc
wav\isolated_digits_ti_train_endpt\WOMAN\RE\ZB_endpt.wav	mfctrain\0_177.mfc
wav\isolated_digits_ti_train_endpt\WOMAN\RN\1A_endpt.wav	mfctrain\1_180.mfc
wav\isolated_digits_ti_train_endpt\WOMAN\RN\1B_endpt.wav	mfctrain\1_181.mfc
wav\isolated_digits_ti_train_endpt\WOMAN\RN\2A_endpt.wav	mfctrain\2_180.mfc
wav\isolated_digits_ti_train_endpt\WOMAN\RN\2B_endpt.wav	mfctrain\2_181.mfc
wav\isolated_digits_ti_train_endpt\WOMAN\RN\3A_endpt.wav	mfctrain\3_178.mfc
wav\isolated_digits_ti_train_endpt\WOMAN\RN\3B_endpt.wav	mfctrain\3_179.mfc
wav\isolated_digits_ti_train_endpt\WOMAN\RN\4A_endpt.wav	mfctrain\4_178.mfc
wav\isolated_digits_ti_train_endpt\WOMAN\RN\4B_endpt.wav	mfctrain\4_179.mfc
wav\isolated_digits_ti_train_endpt\WOMAN\RN\5A_endpt.wav	mfctrain\5_178.mfc
wav\isolated_digits_ti_train_endpt\WOMAN\RN\5B_endpt.wav	mfctrain\5_179.mfc
wav\isolated_digits_ti_train_endpt\WOMAN\RN\6A_endpt.wav	mfctrain\6_178.mfc
wav\isolated_digits_ti_train_endpt\WOMAN\RN\6B_endpt.wav	mfctrain\6_179.mfc
wav\isolated_digits_ti_train_endpt\WOMAN\RN\7A_endpt.wav	mfctrain\7_178.mfc
wav\isolated_digits_ti_train_endpt\WOMAN\RN\7B_endpt.wav	mfctrain\7_179.mfc
wav\isolated_digits_ti_train_endpt\WOMAN\RN\8A_endpt.wav	mfctrain\8_178.mfc
wav\isolated_digits_ti_train_endpt\WOMAN\RN\8B_endpt.wav	mfctrain\8_179.mfc
wav\isolated_digits_ti_train_endpt\WOMAN\RN\9A_endpt.wav	mfctrain\9_178.mfc
wav\isolated_digits_ti_train_endpt\WOMAN\RN\9B_endpt.wav	mfctrain\9_179.mfc
wav\isolated_digits_ti_train_endpt\WOMAN\RN\OA_endpt.wav	mfctrain\10_178.mfc
wav\isolated_digits_ti_train_endpt\WOMAN\RN\OB_endpt.wav	mfctrain\10_179.mfc
wav\isolated_digits_ti_train_endpt\WOMAN\RN\ZA_endpt.wav	mfctrain\0_178.mfc
wav\isolated_digits_ti_train_endpt\WOMAN\RN\ZB_endpt.wav	mfctrain\0_179.mfc
wav\isolated_digits_ti_train_endpt\WOMAN\RP\1A_endpt.wav	mfctrain\1_182.mfc
wav\isolated_digits_ti_train_endpt\WOMAN\RP\1B_endpt.wav	mfctrain\1_183.mfc
wav\isolated_digits_ti_train_endpt\WOMAN\RP\2A_endpt.wav	mfctrain\2_182.mfc
wav\isolated_digits_ti_train_endpt\WOMAN\RP\2B_endpt.wav	mfctrain\2_183.mfc
wav\isolated_digits_ti_train_endpt\WOMAN\RP\3A_endpt.wav	mfctrain\3_180.mfc
wav\isolated_digits_ti_train_endpt\WOMAN\RP\3B_endpt.wav	mfctrain\3_181.mfc
wav\isolated_digits_ti_train_endpt\WOMAN\RP\4A_endpt.wav	mfctrain\4_180.mfc
wav\isolated_digits_ti_train_endpt\WOMAN\RP\4B_endpt.wav	mfctrain\4_181.mfc
wav\isolated_digits_ti_train_endpt\WOMAN\RP\5A_endpt.wav	mfctrain\5_180.mfc
wav\isolated_digits_ti_train_endpt\WOMAN\RP\5B_endpt.wav	mfctrain\5_181.mfc
wav\isolated_digits_ti_train_endpt\WOMAN\RP\6A_endpt.wav	mfctrain\6_180.mfc
wav\isolated_digits_ti_train_endpt\WOMAN\RP\6B_endpt.wav	mfctrain\6_181.mfc
wav\isolated_digits_ti_train_endpt\WOMAN\RP\7A_endpt.wav	mfctrain\7_180.mfc
wav\isolated_digits_ti_train_endpt\WOMAN\RP\7B_endpt.wav	mfctrain\7_181.mfc
wav\isolated_digits_ti_train_endpt\WOMAN\RP\8A_endpt.wav	mfctrain\8_180.mfc
wav\isolated_digits_ti_train_endpt\WOMAN\RP\8B_endpt.wav	mfctrain\8_181.mfc
wav\isolated_digits_ti_train_endpt\WOMAN\RP\9A_endpt.wav	mfctrain\9_180.mfc
wav\isolated_digits_ti_train_endpt\WOMAN\RP\9B_endpt.wav	mfctrain\9_181.mfc
wav\isolated_digits_ti_train_endpt\WOMAN\RP\OA_endpt.wav	mfctrain\10_180.mfc
wav\isolated_digits_ti_train_endpt\WOMAN\RP\OB_endpt.wav	mfctrain\10_181.mfc
wav\isolated_digits_ti_train_endpt\WOMAN\RP\ZA_endpt.wav	mfctrain\0_180.mfc
wav\isolated_digits_ti_train_endpt\WOMAN\RP\ZB_endpt.wav	mfctrain\0_181.mfc
wav\isolated_digits_ti_train_endpt\WOMAN\RR\1A_endpt.wav	mfctrain\1_184.mfc
wav\isolated_digits_ti_train_endpt\WOMAN\RR\1B_endpt.wav	mfctrain\1_185.mfc
wav\isolated_digits_ti_train_endpt\WOMAN\RR\2A_endpt.wav	mfctrain\2_184.mfc
wav\isolated_digits_ti_train_endpt\WOMAN\RR\2B_endpt.wav	mfctrain\2_185.mfc
wav\isolated_digits_ti_train_endpt\WOMAN\RR\3A_endpt.wav	mfctrain\3_182.mfc
wav\isolated_digits_ti_train_endpt\WOMAN\RR\3B_endpt.wav	mfctrain\3_183.mfc
wav\isolated_digits_ti_train_endpt\WOMAN\RR\4A_endpt.wav	mfctrain\4_182.mfc
wav\isolated_digits_ti_train_endpt\WOMAN\RR\4B_endpt.wav	mfctrain\4_183.mfc
wav\isolated_digits_ti_train_endpt\WOMAN\RR\5A_endpt.wav	mfctrain\5_182.mfc
wav\isolated_digits_ti_train_endpt\WOMAN\RR\5B_endpt.wav	mfctrain\5_183.mfc
wav\isolated_digits_ti_train_endpt\WOMAN\RR\6A_endpt.wav	mfctrain\6_182.mfc
wav\isolated_digits_ti_train_endpt\WOMAN\RR\6B_endpt.wav	mfctrain\6_183.mfc
wav\isolated_digits_ti_train_endpt\WOMAN\RR\7A_endpt.wav	mfctrain\7_182.mfc
wav\isolated_digits_ti_train_endpt\WOMAN\RR\7B_endpt.wav	mfctrain\7_183.mfc
wav\isolated_digits_ti_train_endpt\WOMAN\RR\8A_endpt.wav	mfctrain\8_182.mfc
wav\isolated_digits_ti_train_endpt\WOMAN\RR\8B_endpt.wav	mfctrain\8_183.mfc
wav\isolated_digits_ti_train_endpt\WOMAN\RR\9A_endpt.wav	mfctrain\9_182.mfc
wav\isolated_digits_ti_train_endpt\WOMAN\RR\9B_endpt.wav	mfctrain\9_183.mfc
wav\isolated_digits_ti_train_endpt\WOMAN\RR\OA_endpt.wav	mfctrain\10_182.mfc
wav\isolated_digits_ti_train_endpt\WOMAN\RR\OB_endpt.wav	mfctrain\10_183.mfc
wav\isolated_digits_ti_train_endpt\WOMAN\RR\ZA_endpt.wav	mfctrain\0_182.mfc
wav\isolated_digits_ti_train_endpt\WOMAN\RR\ZB_endpt.wav	mfctrain\0_183.mfc
wav\isolated_digits_ti_train_endpt\WOMAN\RS\1A_endpt.wav	mfctrain\1_186.mfc
wav\isolated_digits_ti_train_endpt\WOMAN\RS\1B_endpt.wav	mfctrain\1_187.mfc
wav\isolated_digits_ti_train_endpt\WOMAN\RS\2A_endpt.wav	mfctrain\2_186.mfc
wav\isolated_digits_ti_train_endpt\WOMAN\RS\2B_endpt.wav	mfctrain\2_187.mfc
wav\isolated_digits_ti_train_endpt\WOMAN\RS\3A_endpt.wav	mfctrain\3_184.mfc
wav\isolated_digits_ti_train_endpt\WOMAN\RS\3B_endpt.wav	mfctrain\3_185.mfc
wav\isolated_digits_ti_train_endpt\WOMAN\RS\4A_endpt.wav	mfctrain\4_184.mfc
wav\isolated_digits_ti_train_endpt\WOMAN\RS\4B_endpt.wav	mfctrain\4_185.mfc
wav\isolated_digits_ti_train_endpt\WOMAN\RS\5A_endpt.wav	mfctrain\5_184.mfc
wav\isolated_digits_ti_train_endpt\WOMAN\RS\5B_endpt.wav	mfctrain\5_185.mfc
wav\isolated_digits_ti_train_endpt\WOMAN\RS\6A_endpt.wav	mfctrain\6_184.mfc
wav\isolated_digits_ti_train_endpt\WOMAN\RS\6B_endpt.wav	mfctrain\6_185.mfc
wav\isolated_digits_ti_train_endpt\WOMAN\RS\7A_endpt.wav	mfctrain\7_184.mfc
wav\isolated_digits_ti_train_endpt\WOMAN\RS\7B_endpt.wav	mfctrain\7_185.mfc
wav\isolated_digits_ti_train_endpt\WOMAN\RS\8A_endpt.wav	mfctrain\8_184.mfc
wav\isolated_digits_ti_train_endpt\WOMAN\RS\8B_endpt.wav	mfctrain\8_185.mfc
wav\isolated_digits_ti_train_endpt\WOMAN\RS\9A_endpt.wav	mfctrain\9_184.mfc
wav\isolated_digits_ti_train_endpt\WOMAN\RS\9B_endpt.wav	mfctrain\9_185.mfc
wav\isolated_digits_ti_train_endpt\WOMAN\RS\OA_endpt.wav	mfctrain\10_184.mfc
wav\isolated_digits_ti_train_endpt\WOMAN\RS\OB_endpt.wav	mfctrain\10_185.mfc
wav\isolated_digits_ti_train_endpt\WOMAN\RS\ZA_endpt.wav	mfctrain\0_184.mfc
wav\isolated_digits_ti_train_endpt\WOMAN\RS\ZB_endpt.wav	mfctrain\0_185.mfc
wav\isolated_digits_ti_train_endpt\WOMAN\SP\1A_endpt.wav	mfctrain\1_188.mfc
wav\isolated_digits_ti_train_endpt\WOMAN\SP\1B_endpt.wav	mfctrain\1_189.mfc
wav\isolated_digits_ti_train_endpt\WOMAN\SP\2A_endpt.wav	mfctrain\2_188.mfc
wav\isolated_digits_ti_train_endpt\WOMAN\SP\2B_endpt.wav	mfctrain\2_189.mfc
wav\isolated_digits_ti_train_endpt\WOMAN\SP\3A_endpt.wav	mfctrain\3_186.mfc
wav\isolated_digits_ti_train_endpt\WOMAN\SP\3B_endpt.wav	mfctrain\3_187.mfc
wav\isolated_digits_ti_train_endpt\WOMAN\SP\4A_endpt.wav	mfctrain\4_186.mfc
wav\isolated_digits_ti_train_endpt\WOMAN\SP\4B_endpt.wav	mfctrain\4_187.mfc
wav\isolated_digits_ti_train_endpt\WOMAN\SP\5A_endpt.wav	mfctrain\5_186.mfc
wav\isolated_digits_ti_train_endpt\WOMAN\SP\5B_endpt.wav	mfctrain\5_187.mfc
wav\isolated_digits_ti_train_endpt\WOMAN\SP\6A_endpt.wav	mfctrain\6_186.mfc
wav\isolated_digits_ti_train_endpt\WOMAN\SP\6B_endpt.wav	mfctrain\6_187.mfc
wav\isolated_digits_ti_train_endpt\WOMAN\SP\7A_endpt.wav	mfctrain\7_186.mfc
wav\isolated_digits_ti_train_endpt\WOMAN\SP\7B_endpt.wav	mfctrain\7_187.mfc
wav\isolated_digits_ti_train_endpt\WOMAN\SP\8A_endpt.wav	mfctrain\8_186.mfc
wav\isolated_digits_ti_train_endpt\WOMAN\SP\8B_endpt.wav	mfctrain\8_187.mfc
wav\isolated_digits_ti_train_endpt\WOMAN\SP\9A_endpt.wav	mfctrain\9_186.mfc
wav\isolated_digits_ti_train_endpt\WOMAN\SP\9B_endpt.wav	mfctrain\9_187.mfc
wav\isolated_digits_ti_train_endpt\WOMAN\SP\OA_endpt.wav	mfctrain\10_186.mfc
wav\isolated_digits_ti_train_endpt\WOMAN\SP\OB_endpt.wav	mfctrain\10_187.mfc
wav\isolated_digits_ti_train_endpt\WOMAN\SP\ZA_endpt.wav	mfctrain\0_186.mfc
wav\isolated_digits_ti_train_endpt\WOMAN\SP\ZB_endpt.wav	mfctrain\0_187.mfc
